Script started on 2020-04-08 18:39:59-0700
mangahk@linux-07:~/Desktop$ l[Kls
'cscl301 hw'   homework   typescript
mangahk@linux-07:~/Desktop$ mkdir csci [K241
mangahk@linux-07:~/Desktop$ ls
 csci241  'cscl301 hw'	 homework   typescript
mangahk@linux-07:~/Desktop$ cd sc[K[Kcsci241
mangahk@linux-07:~/Desktop/csci241$ ls
mangahk@linux-07:~/Desktop/csci241$ git clone https://github.com/csci241-20s/lab--1-Keegan-Mangahas
Cloning into 'lab-1-Keegan-Mangahas'...
remote: Enumerating objects: 14, done.[K
remote: Counting objects:   7% (1/14)[Kremote: Counting objects:  14% (2/14)[Kremote: Counting objects:  21% (3/14)[Kremote: Counting objects:  28% (4/14)[Kremote: Counting objects:  35% (5/14)[Kremote: Counting objects:  42% (6/14)[Kremote: Counting objects:  50% (7/14)[Kremote: Counting objects:  57% (8/14)[Kremote: Counting objects:  64% (9/14)[Kremote: Counting objects:  71% (10/14)[Kremote: Counting objects:  78% (11/14)[Kremote: Counting objects:  85% (12/14)[Kremote: Counting objects:  92% (13/14)[Kremote: Counting objects: 100% (14/14)[Kremote: Counting objects: 100% (14/14), done.[K
remote: Compressing objects:  12% (1/8)[Kremote: Compressing objects:  25% (2/8)[Kremote: Compressing objects:  37% (3/8)[Kremote: Compressing objects:  50% (4/8)[Kremote: Compressing objects:  62% (5/8)[Kremote: Compressing objects:  75% (6/8)[Kremote: Compressing objects:  87% (7/8)[Kremote: Compressing objects: 100% (8/8)[Kremote: Compressing objects: 100% (8/8), done.[K
remote: Total 14 (delta 2), reused 0 (delta 0), pack-reused 0[K
Unpacking objects:   7% (1/14)   Unpacking objects:  14% (2/14)   Unpacking objects:  21% (3/14)   Unpacking objects:  28% (4/14)   Unpacking objects:  35% (5/14)   Unpacking objects:  42% (6/14)   Unpacking objects:  50% (7/14)   Unpacking objects:  57% (8/14)   Unpacking objects:  64% (9/14)   Unpacking objects:  71% (10/14)   Unpacking objects:  78% (11/14)   Unpacking objects:  85% (12/14)   Unpacking objects:  92% (13/14)   Unpacking objects: 100% (14/14)   Unpacking objects: 100% (14/14), done.
mangahk@linux-07:~/Desktop/csci241$ ls
lab-1-Keegan-Mangahas
mangahk@linux-07:~/Desktop/csci241$ cd lab-1-Keegan-Mangahas/
mangahk@linux-07:~/Desktop/csci241/lab-1-Keegan-Mangahas$ git config --globAL[K[Kal us er.name "Keegan"
mangahk@linux-07:~/Desktop/csci241/lab-1-Keegan-Mangahas$ git config --globaL[Kl us er.email mangahk@wwu.edu
mangahk@linux-07:~/Desktop/csci241/lab-1-Keegan-Mangahas$ touch writeup.txt
mangahk@linux-07:~/Desktop/csci241/lab-1-Keegan-Mangahas$ git add writeup.txt
mangahk@linux-07:~/Desktop/csci241/lab-1-Keegan-Mangahas$ git commit -m "Added e mpty write u[K[Kup"
[master f81844e] Added empty writeup
 1 file changed, 0 insertions(+), 0 deletions(-)
 create mode 100644 writeup.txt
mangahk@linux-07:~/Desktop/csci241/lab-1-Keegan-Mangahas$ git push
Username for 'https://github.com': Keegan
Password for 'https://Keegan@github.com': 
remote: Invalid username or password.
fatal: Authentication failed for 'https://github.com/csci241-20s/lab-1-Keegan-Mangahas/'
mangahk@linux-07:~/Desktop/csci241/lab-1-Keegan-Mangahas$ git push
Username for 'https://github.com': mangahk@wwu.edu
Password for 'https://mangahk@wwu.edu@github.com': 
remote: Invalid username or password.
fatal: Authentication failed for 'https://github.com/csci241-20s/lab-1-Keegan-Mangahas/'
mangahk@linux-07:~/Desktop/csci241/lab-1-Keegan-Mangahas$ git push
Username for 'https://github.com': Keegan
Password for 'https://Keegan@github.com': 
remote: Invalid username or password.
fatal: Authentication failed for 'https://github.com/csci241-20s/lab-1-Keegan-Mangahas/'
mangahk@linux-07:~/Desktop/csci241/lab-1-Keegan-Mangahas$ git push
Username for 'https://github.com': Keegan-Mangahas
Password for 'https://Keegan-Mangahas@github.com': 
remote: Invalid username or password.
fatal: Authentication failed for 'https://github.com/csci241-20s/lab-1-Keegan-Mangahas/'
mangahk@linux-07:~/Desktop/csci241/lab-1-Keegan-Mangahas$ git push origin master [A[C[C[C[C[C[C[C[C[C[C[C[C[C[C[C[C[C[C[C[C[C[C[C[C[C[C[C[C[C[C[C[C[C[C[C[C[C[C[C[C[C[C[C[C[C[C[C[C[C[C[C[C[C[C[C[C[C[C[C[C[C[C[C[C[C[C[C[C[C[C[C[C[C[C[C[C[C[C[C[Kr
Username for 'https://github.com': Keegan-Man          mangahk@wwu.edu
Password for 'https://mangahk@wwu.edu@github.com': 
remote: Invalid username or password.
fatal: Authentication failed for 'https://github.com/csci241-20s/lab-1-Keegan-Mangahas/'
mangahk@linux-07:~/Desktop/csci241/lab-1-Keegan-Mangahas$ git push origin master [A[C[C[C[C[C[C[C[C[C[C[C[C[C[C[C[C[C[C[C[C[C[C[C[C[C[C[C[C[C[C[C[C[C[C[C[C[C[C[C[C[C[C[C[C[C[C[C[C[C[C[C[C[C[C[C[C[C[C[C[C[C[C[C[C[C[C[C[C[C[C[C[C[C[C[C[C[C[C[C[Kr
Username for 'https://github.com': Keegan-Mangahas
Password for 'https://Keegan-Mangahas@github.com': 
remote: Invalid username or password.
fatal: Authentication failed for 'https://github.com/csci241-20s/lab-1-Keegan-Mangahas/'
mangahk@linux-07:~/Desktop/csci241/lab-1-Keegan-Mangahas$ git push -a
error: unknown switch `a'
usage: git push [<options>] [<repository> [<refspec>...]]

    -v, --verbose         be more verbose
    -q, --quiet           be more quiet
    --repo <repository>   repository
    --all                 push all refs
    --mirror              mirror all refs
    -d, --delete          delete refs
    --tags                push tags (can't be used with --all or --mirror)
    -n, --dry-run         dry run
    --porcelain           machine-readable output
    -f, --force           force updates
    --force-with-lease[=<refname>:<expect>]
                          require old value of ref to be at this value
    --recurse-submodules[=<check|on-demand|no>]
                          control recursive pushing of submodules
    --thin                use thin pack
    --receive-pack <receive-pack>
                          receive pack program
    --exec <receive-pack>
                          receive pack program
    -u, --set-upstream    set upstream for git pull/status
    --progress            force progress reporting
    --prune               prune locally removed refs
    --no-verify           bypass pre-push hook
    --follow-tags         push missing but relevant tags
    --signed[=<yes|no|if-asked>]
                          GPG sign the push
    --atomic              request atomic transaction on remote side
    -o, --push-option <server-specific>
                          option to transmit
    -4, --ipv4            use IPv4 addresses only
    -6, --ipv6            use IPv6 addresses only

mangahk@linux-07:~/Desktop/csci241/lab-1-Keegan-Mangahas$ git paush [K[K[K[K[Kush -u
Username for 'https://github.com': Keegan-Mangahas
Password for 'https://Keegan-Mangahas@github.com': 
Counting objects: 2, done.
Delta compression using up to 8 threads.
Compressing objects:  50% (1/2)   Compressing objects: 100% (2/2)   Compressing objects: 100% (2/2), done.
Writing objects:  50% (1/2)   Writing objects: 100% (2/2)   Writing objects: 100% (2/2), 265 bytes | 265.00 KiB/s, done.
Total 2 (delta 1), reused 0 (delta 0)
remote: Resolving deltas:   0% (0/1)[Kremote: Resolving deltas: 100% (1/1)[Kremote: Resolving deltas: 100% (1/1), completed with 1 local object.[K
To https://github.com/csci241-20s/lab-1-Keegan-Mangahas
   8fb3769..f81844e  master -> master
Branch 'master' set up to track remote branch 'master' from 'origin'.
mangahk@linux-07:~/Desktop/csci241/lab-1-Keegan-Mangahas$ ls
build.gradle  settings.gradle  src  writeup.txt
mangahk@linux-07:~/Desktop/csci241/lab-1-Keegan-Mangahas$ writeup.txt
writeup.txt: command not found
mangahk@linux-07:~/Desktop/csci241/lab-1-Keegan-Mangahas$ cs[Kd writeup.txt
bash: cd: writeup.txt: Not a directory
mangahk@linux-07:~/Desktop/csci241/lab-1-Keegan-Mangahas$ vi writeup.txt
[?2004h[?1049h[22;0;0t[?1h=[?2004h[1;24r[?12h[?12l[27m[23m[29m[m[H[2J[?25l[24;1H"writeup.txt" 0L, 0C[2;1H▽[6n[2;1H  [1;1H[>c]10;?]11;?[2;1H[1m[34m~                                                                               [3;1H~                                                                               [4;1H~                                                                               [5;1H~                                                                               [6;1H~                                                                               [7;1H~                                                                               [8;1H~                                                                               [9;1H~                                                                               [10;1H~                                                                               [11;1H~                                                                               [12;1H~                                                                               [13;1H~                                                                               [14;1H~                                                                               [15;1H~                                                                               [16;1H~                                                                               [17;1H~                                                                               [18;1H~                                                                               [19;1H~                                                                               [20;1H~                                                                               [21;1H~                                                                               [22;1H~                                                                               [23;1H~                                                                               [m[24;63H0,0-1[9CAll[1;1H[?25h[27m[23m[29m[m[H[2J[?25l[2;1H[1m[34m~                                                                               [3;1H~                                                                               [4;1H~                                                                               [5;1H~                                                                               [6;1H~                                                                               [7;1H~                                                                               [8;1H~                                                                               [9;1H~                                                                               [10;1H~                                                                               [11;1H~                                                                               [12;1H~                                                                               [13;1H~                                                                               [14;1H~                                                                               [15;1H~                                                                               [16;1H~                                                                               [17;1H~                                                                               [18;1H~                                                                               [19;1H~                                                                               [20;1H~                                                                               [21;1H~                                                                               [22;1H~                                                                               [23;1H~                                                                               [m[24;63H0,0-1[9CAll"writeup.txt" 0L, 0C[1;1H[?25h[?25l[24;53HK[1;1H[24;1H[1m[37m[41mE349: No identifier under cursor[m[24;53H[K[1;1H[24;63H0,0-1[9CAll[1;1H[?25h[?25l[24;53He[1;1H[24;53H [1;1H[?25h[?25l[24;53He[1;1H[24;53H [1;1H[?25h[?25l[24;53Hg[1;1H[?25h[?25l[24;53H [1;1H[24;53Hg[1;1H[?25h[?25l[24;54Hi[1;1H[24;53H  [1;1H[24;1H[1m--[m[1m[37m[41m4[m[1m INSERT --[m[1m[37m[41mn[m[24;13H[K[24;63H0,1[11CAll[1;1H[?25h[?25lK[24;63H1,2[1;2H[?25h[?25le[24;65H3[1;3H[?25h[?25le[24;65H4[1;4H[?25h[?25lg[24;65H5[1;5H[?25h[?25la[24;65H6[1;6H[?25h[?25ln[24;65H7[1;7H[?25h[?25l[24;65H8[1;8H[?25h[?25lM[24;65H9[1;9H[?25h[?25la[24;65H10[1;10H[?25h[?25ln[24;66H1[1;11H[?25h[?25lg[24;66H2[1;12H[?25h[?25la[24;66H3[1;13H[?25h[?25lh[24;66H4[1;14H[?25h[?25la[24;66H5[1;15H[?25h[?25ls[24;66H6[1;16H[?25h[24;1H[K[1;15H[?25l[24;53H^[[1;15H[24;53H  [1;16H[24;63H1,15[10CAll[1;15H[?25h[?25l[24;53H^M[1;15H[24;53H  [1;15H[?25h[?25l[24;53Hq[1;15H[?25h[?25l[24;54Hq[1;15H[24;1H[1mrecording @q[m[24;53H[K[24;63H1,15[10CAll[1;15H[?25h[?25l[24;53Hq[1;15H[24;1H[K[1;15H[24;63H1,15[10CAll[1;15H[?25h[?25l[24;53Hx[1;15H[24;53H [1;15H[24;53Hdl[1;15H[24;53H  [1;14H[1;15H[K[24;66H4[1;14H[?25h[?25l[24;53Hs[1;14H[24;53H [1;14H[24;53Hcl[1;14H[24;53H  [1;14H[24;1H[1m-- INSERT --[m[24;63H[K[24;63H1,14[10CAll[1;14H[K[1;14H[?25h[?25la[24;66H5[1;15H[?25h[?25ls[24;66H6[1;16H[?25h[24;1H[K[1;15H[?25l[24;53H^[[1;15H[24;53H  [1;16H[24;63H1,15[10CAll[1;15H[?25h[?25l[24;53Hs[1;15H[24;53H [1;15H[24;53Hcl[1;15H[24;53H  [1;15H[24;1H[1m-- INSERT --[m[24;63H[K[24;63H1,15[10CAll[1;15H[K[1;15H[?25h[?25ls[24;66H6[1;16H[?25h[24;1H[K[1;15H[?25l[24;53H^[[1;15H[24;53H  [1;16H[24;63H1,15[10CAll[1;15H[?25h[?25l[24;53H^[[1;15H[24;53H  [1;15H[24;53H^[[1;15H[24;53H  [1;15H[?25h[?25l[24;53H~@k[1;15H[24;53H   [1;15H[?25h[?25l[24;53H~@k[1;15H[24;53H   [1;15H[?25h[?25l[24;53H~@k[1;15H[24;53H   [1;15H[?25h[?25l[24;53H~@k[1;15H[24;53H   [1;15H[?25h[?25l[24;53H~@k[1;15H[24;53H   [1;15H[?25h[?25l[24;53H^[[1;15H[24;53H  [1;15H[24;53H^[[1;15H[24;53H  [1;15H[?25h[?25l[24;53Hi[1;15H[24;53H [1;15H[24;1H[1m-- INSERT --[m[24;63H[K[24;63H1,15[10CAll[1;15H[?25h[?25l[24;66H6[1;16H[?25h[24;1H[K[1;15H[?25l[24;53H^[[1;15H[24;53H  [1;16H[24;63H1,15[10CAll[1;15H[?25h[?25l[24;53Hx[1;15H[24;53H [1;15H[24;53Hdl[1;15H[24;53H  [1;14H[1;15H[K[24;66H4[1;14H[?25h[?25l[24;53Hi[1;14H[24;53H [1;14H[24;1H[1m-- INSERT --[m[24;63H[K[24;63H1,14[10CAll[1;14H[?25h[?25l[24;66H5[1;15H[?25h[?25ls[24;66H6[1;16H[?25h[?25l[2;1H[K[24;63H2,1 [2;1H[?25h[24;1H[K[2;1H[?25l[24;53H^[[2;1H[24;53H  [2;1H[24;63H2,0-1[9CAll[2;1H[?25h[?25l[24;53Hs[2;1H[24;53H [2;1H[24;53Hcl[2;1H[24;53H  [2;1H[24;1H[1m-- INSERT --[m[24;63H[K[24;63H2,1[11CAll[2;1H[?25h[?25ls[24;65H2[2;2H[?25h[?25l[2;1H[K[24;65H1[2;1H[?25h[24;1H[K[2;1H[?25l[24;53H^[[2;1H[24;53H  [2;1H[24;63H2,0-1[9CAll[2;1H[?25h[?25l[24;53H;[2;1H[24;53H [2;1H[?25h[?25l[24;53H;[2;1H[24;53H [2;1H[?25h[?25l[24;53Hq[2;1H[?25h[?25l[24;54H:[2;1H[24;53H  [2;1H[24;63H[K[24;1H:[?2004h[15;1H[7mwriteup.txt [+]                                               2,0-1          All[m[16;1H[1m[34m:[m[16;2H[K[17;1H[1m[34m:
:
:
:
:
:[17;2H~
:~
:~
:~
:~
:~[m
[1m[7m[Command Line]                                                1,0-1          All[16;2H[?25h[?25l[m[24;70H:^[[16;2H[24;71H  [16;2H[24;71H^[[16;2H[24;70H   [16;2H[?25h[?25l[24;70Hgq[16;2H[?25h[?25l[24;72H:[16;2H[24;1H[K[24;1H:[?2004h[?25hQ[?25l[?25h[?25l[1m[37m[41mE492: Not an editor command: Q[16;2H[?25h[?25l[m[24;70H:[16;2H[24;1H[K[24;1H:[?2004h[?25hQ[?25l[?25h[?25l[24;2H[K[24;2H[?25hq[?25l[?25h[?25l[16;2H[24;1H[K[15;1H[1m[34m~                                                                               [16;1H~                   Script started on 2020-04-08 18:56:59-0700
mangahk@linux-07:~/Desktop$ cd sc[K[Kcsci241
mangahk@linux-07:~/Desktop/csci241$ ls
lab-1-Keegan-Mangahas
mangahk@linux-07:~/Desktop/csci241$ cd lab-1-Keegan-Mangahas/
mangahk@linux-07:~/Desktop/csci241/lab-1-Keegan-Mangahas$ ls
build.gradle  settings.gradle  src  writeup.txt
mangahk@linux-07:~/Desktop/csci241/lab-1-Keegan-Mangahas$ nano writeup.txt
[?1049h[22;0;0t[1;24r(B[m[4l[?7h[39;49m[?1h=[?1h=[?1h=[?25l[39;49m(B[m[H[2J[22d(B[0;7mFile ...eup.txt is being edited (by mangahk with VIM 8.0, PID 25801); continue? [23;1H Y(B[m Yes[24d(B[0;7m N(B[m No[24;17H(B[0;7m^C(B[m Cancel[22;80H[?12l[?25h[?25l[22;32H[1K (B[0;7m[ Reading File ](B[m[K[22;39H(B[0;7m 0 lines ](B[m[H(B[0;7m  GNU nano 2.9.3                     writeup.txt                                [1;79H(B[m[23d(B[0;7m^G(B[m Get Help  (B[0;7m^O(B[m Write Out (B[0;7m^W(B[m Where Is  (B[0;7m^K(B[m Cut Text  (B[0;7m^J(B[m Justify   (B[0;7m^C(B[m Cur Pos[24d(B[0;7m^X(B[m Exit[14G(B[0;7m^R(B[m Read File (B[0;7m^\(B[m Replace   (B[0;7m^U(B[m Uncut Text(B[0;7m^T(B[m To Spell  (B[0;7m^_(B[m Go To Line[22d[3d[39;49m(B[m[?12l[?25h[?25l[1;71H(B[0;7mModified(B[m[3dK[?12l[?25h[?25le[?12l[?25h[?25le[?12l[?25h[?25lg[?12l[?25h[?25la[?12l[?25h[?25ln[?12l[?25h[?25l [?12l[?25h[?25lM[?12l[?25h[?25la[?12l[?25h[?25ln[?12l[?25h[?25lg[?12l[?25h[?25la[?12l[?25h[?25lh[?12l[?25h[?25la[?12l[?25h[?25ls[?12l[?25h[?25l[22d(B[0;7mSave modified buffer?  (Answering "No" will DISCARD changes.)                   [23;1H Y(B[m Yes[K[24d(B[0;7m N(B[m No  [14G   (B[0;7m^C(B[m Cancel[K[22;63H[?12l[?25h[?25l[23d(B[0;7m^G(B[m Get Help[23;21H(B[0;7mM-D(B[m DOS Format[41G(B[0;7mM-A(B[m Append[23;61H(B[0;7mM-B(B[m Backup File[24d(B[0;7m^C(B[m Cancel[17G    (B[0;7mM-M(B[m Mac Format[41G(B[0;7mM-P(B[m Prepend[24;61H(B[0;7m^T(B[m To Files[22d(B[0;7mFile Name to Write: writeup.txt                              (B[m[22;32H[?12l[?25h[?25l[K[1;79H[1;71H(B[0;7m        (B[m[22;33H(B[0;7m[ Wrote 1 line ](B[m[J[24;80H[?12l[?25h[24;1H[?1049l[23;0;0t[?1l>mangahk@linux-07:~/Desktop/csci241/lab-1-Keegan-Mangahas$ git add writeup.txt
mangahk@linux-07:~/Desktop/csci241/lab-1-Keegan-Mangahas$ git comit[K[Kmit -m "Added p art 1 (names) to writeup"
[master aacffce] Added part 1 (names) to writeup
 1 file changed, 1 insertion(+)
mangahk@linux-07:~/Desktop/csci241/lab-1-Keegan-Mangahas$ git status
On branch master
Your branch is ahead of 'origin/master' by 1 commit.
  (use "git push" to publish your local commits)

nothing to commit, working tree clean
mangahk@linux-07:~/Desktop/csci241/lab-1-Keegan-Mangahas$ nano writeup.txt
[?1049h[22;0;0t[1;24r(B[m[4l[?7h[39;49m[?1h=[?1h=[?1h=[?25l[39;49m(B[m[H[2J[22;33H(B[0;7m[ Reading File ](B[m[22;39H(B[0;7m 1 line ](B[m[K[H(B[0;7m  GNU nano 2.9.3                     writeup.txt                                [1;79H(B[m[23d(B[0;7m^G(B[m Get Help  (B[0;7m^O(B[m Write Out (B[0;7m^W(B[m Where Is  (B[0;7m^K(B[m Cut Text  (B[0;7m^J(B[m Justify   (B[0;7m^C(B[m Cur Pos[24d(B[0;7m^X(B[m Exit[14G(B[0;7m^R(B[m Read File (B[0;7m^\(B[m Replace   (B[0;7m^U(B[m Uncut Text(B[0;7m^T(B[m To Spell  (B[0;7m^_(B[m Go To Line[22d[3d[39;49m(B[mKeegan Mangahas[?12l[?25h[?25l[4d[?12l[?25h[?25l[1;71H(B[0;7mModified(B[m[4dH[?12l[?25h[?25lo[?12l[?25h[?25lb[?12l[?25h[?25lb[?12l[?25h[?25ly[?12l[?25h[?25l:[?12l[?25h[?25l [?12l[?25h[?25lP[?12l[?25h[?25ll[?12l[?25h[?25la[?12l[?25h[?25ly[?12l[?25h[?25li[?12l[?25h[?25ln[?12l[?25h[?25lg[?12l[?25h[?25l [?12l[?25h[?25lg[?12l[?25h[?25lu[?12l[?25h[?25li[?12l[?25h[?25lt[?12l[?25h[?25la[?12l[?25h[?25lr[?12l[?25h[?25l[22d(B[0;7mSave modified buffer?  (Answering "No" will DISCARD changes.)                   [23;1H Y(B[m Yes[K[24d(B[0;7m N(B[m No  [14G   (B[0;7m^C(B[m Cancel[K[22;63H[?12l[?25h[?25l[23d(B[0;7m^G(B[m Get Help[23;21H(B[0;7mM-D(B[m DOS Format[41G(B[0;7mM-A(B[m Append[23;61H(B[0;7mM-B(B[m Backup File[24d(B[0;7m^C(B[m Cancel[17G    (B[0;7mM-M(B[m Mac Format[41G(B[0;7mM-P(B[m Prepend[24;61H(B[0;7m^T(B[m To Files[22d(B[0;7mFile Name to Write: writeup.txt                              (B[m[22;32H[?12l[?25h[?25l[K[1;79H[1;71H(B[0;7m        (B[m[22;32H(B[0;7m[ Wrote 2 lines ](B[m[J[24;80H[?12l[?25h[24;1H[?1049l[23;0;0t[?1l>mangahk@linux-07:~/Desktop/csci241/lab-1-Keegan-Mangahas$ git status
On branch master
Your branch is ahead of 'origin/master' by 1 commit.
  (use "git push" to publish your local commits)

Changes not staged for commit:
  (use "git add <file>..." to update what will be committed)
  (use "git checkout -- <file>..." to discard changes in working directory)

	[31mmodified:   writeup.txt[m

no changes added to commit (use "git add" and/or "git commit -a")
mangahk@linux-07:~/Desktop/csci241/lab-1-Keegan-Mangahas$ git commet -m "Added p art 2 (o[Khobbies) to writeup"
git: 'commet' is not a git command. See 'git --help'.

The most similar command is
	commit
mangahk@linux-07:~/Desktop/csci241/lab-1-Keegan-Mangahas$ git commet -m "Added paart 2 (hobbies) to writeup"[A[C[C[C[C[C[C[C[C[C[C[C[C[C[C[C[C[C[C[C[C[C[C[C[C[C[C[C[C[C[C[C[C[C[C[C[12Pstatus
[K[A[C[C[C[C[C[C[C[C[C[C[C[C[C[C[C[C[C[C[C[C[C[C[C[C[C[C[C[C[C[C[C[C[C[C[C[C[C[C[C[C[C[C[C[C[C[C[C[C[C[C[C[C[C[C[C[C[C[C[C[C[C[C[C[C[C[C[C[Ccommet -m "Added paart 2 (hobbies) to writeup"[A[C[C[C[C[C[C[C[C[C[C[C[C[C[C[C[C[C[C[C[C[C[C[C[C[C[C[C[C[C[C[C[C[C[C[C[C[C[C[C[C[C[C[C[C[C[C[C[C[C[C[C[C[C[C[C[C[C[C[C[C[C[C[C[C[C[C[C[C[C[C[C[C[C[C[C[C[C[C[Ct -m "Added par[1P[A[C[C[C[C[C[C[C[C[C[C[C[C[C[C[C[C[C[C[C[C[C[C[C[C[C[C[C[C[C[C[C[C[C[C[C[C[C[C[C[C[C[C[C[C[C[C[C[C[C[C[C[C[C[C[C[C[C[C[C[C[C[C[C[C[Cit -m "Added pa[1@r[A[C[C[C[C[C[C[C[C[C[C[C[C[C[C[C[C[C[C[C[C[C[C[C[C[C[C[C[C[C[C[C[C[C[C[C[C[C[C[C[C[C[C[C[C[C[C[C[C[C[C[C[C[C[C[C[C[C[C[C[C[C[C[C[C[C

On branch master
Your branch is ahead of 'origin/master' by 1 commit.
  (use "git push" to publish your local commits)

Changes not staged for commit:
	[31mmodified:   writeup.txt[m

no changes added to commit
mangahk@linux-07:~/Desktop/csci241/lab-1-Keegan-Mangahas$ git commit -m "Added paart 2 (hobbies) to writeup"[A[C[C[C[C[C[C[C[C[C[C[C[C[C[C[C[C[C[C[C[C[C[C[C[C[C[C[C[C[C[C[C[C[C[C[C[C[C[C[Ce
[C[C[C[C[C[C[C[C[C[C[C[C[C[C[C[C[C[C[C[C[C[C[C[C[C[C[C[A[C[C[C[C[C[C[C[C[C[C[C[C[C[C[C[C[C[C[C[C[C[C[C[C[C[C[C[C[C[C[C[C[C[C[C[C[C[C[Ci
[C[C[C[C[C[C[C[C[C[C[C[C[C[C[C[C[C[C[C[C[C[C[C[C[C[C[C[A[C[C[C[C[C[C[C[C[C[C[C[C[C[C[C[C[C[C[C[C[C[C[C[C[C[C[C[C[C[C[C[K
[K[A[C[C[C[C[C[C[C[C[C[C[C[C[C[C[C[C[C[C[C[C[C[C[C[C[C[C[C[C[C[C[C[C[C[C[C[C[C[C[C[C[C[C[C[C[C[C[C[C[C[C[C[C[C[C[C[C[C[Cgit status
On branch master
Your branch is ahead of 'origin/master' by 1 commit.
  (use "git push" to publish your local commits)

Changes not staged for commit:
  (use "git add <file>..." to update what will be committed)
  (use "git checkout -- <file>..." to discard changes in working directory)

	[31mmodified:   writeup.txt[m

no changes added to commit (use "git add" and/or "git commit -a")
mangahk@linux-07:~/Desktop/csci241/lab-1-Keegan-Mangahas$ git add writeup.txt
mangahk@linux-07:~/Desktop/csci241/lab-1-Keegan-Mangahas$ git com[K[K[K[K[K[K[Kgit add writeup.txt[9Pstatuscommit -m "Added paart 2 (hobbies) to writeup"
[master 3a501bf] Added part 2 (hobbies) to writeup
 1 file changed, 1 insertion(+)
mangahk@linux-07:~/Desktop/csci241/lab-1-Keegan-Mangahas$ git status
On branch master
Your branch is ahead of 'origin/master' by 2 commits.
  (use "git push" to publish your local commits)

nothing to commit, working tree clean
mangahk@linux-07:~/Desktop/csci241/lab-1-Keegan-Mangahas$ touch writeup[K[K[K[K[K[K[Kusernamet[K.txt
mangahk@linux-07:~/Desktop/csci241/lab-1-Keegan-Mangahas$ ls
build.gradle  settings.gradle  src  username.txt  writeup.txt
mangahk@linux-07:~/Desktop/csci241/lab-1-Keegan-Mangahas$ nano username.txt
[?1049h[22;0;0t[1;24r(B[m[4l[?7h[39;49m[?1h=[?1h=[?1h=[?25l[39;49m(B[m[H[2J[22;33H(B[0;7m[ Reading File ](B[m[22;39H(B[0;7m 0 lines ](B[m[H(B[0;7m  GNU nano 2.9.3                     username.txt                               [1;79H(B[m[23d(B[0;7m^G(B[m Get Help  (B[0;7m^O(B[m Write Out (B[0;7m^W(B[m Where Is  (B[0;7m^K(B[m Cut Text  (B[0;7m^J(B[m Justify   (B[0;7m^C(B[m Cur Pos[24d(B[0;7m^X(B[m Exit[14G(B[0;7m^R(B[m Read File (B[0;7m^\(B[m Replace   (B[0;7m^U(B[m Uncut Text(B[0;7m^T(B[m To Spell  (B[0;7m^_(B[m Go To Line[22d[3d[39;49m(B[m[?12l[?25h[?25l[1;71H(B[0;7mModified(B[m[3dK[?12l[?25h[?25le[?12l[?25h[?25le[?12l[?25h[?25lg[?12l[?25h[?25la[?12l[?25h[?25ln[?12l[?25h[?25l [?12l[?25h[?25lM[?12l[?25h[?25la[?12l[?25h[?25ln[?12l[?25h[?25lg[?12l[?25h[?25la[?12l[?25h[?25lh[?12l[?25h[?25la[?12l[?25h[?25ls[?12l[?25h[?25l[4d[?12l[?25h[?25lM[?12l[?25h[?25l[K[?12l[?25h[?25lm[?12l[?25h[?25la[?12l[?25h[?25ln[?12l[?25h[?25lg[?12l[?25h[?25la[?12l[?25h[?25lh[?12l[?25h[?25la[?12l[?25h[?25lk[22d[K[4;9H[?12l[?25h[?25l [?12l[?25h[?25l [?12l[?25h[?25l [?12l[?25h[?25l [?12l[?25h[?25l [?12l[?25h[?25l [?12l[?25h[?25l [?12l[?25h[?25l[K[?12l[?25h[?25l[3;16H[?12l[?25h[?25l,[?12l[?25h[?25l [?12l[?25h[?25lm[?12l[?25h[?25la[?12l[?25h[?25ln[?12l[?25h[?25lg[?12l[?25h[?25la[?12l[?25h[?25lh[?12l[?25h[?25lk[?12l[?25h[?25l,[?12l[?25h[?25l [?12l[?25h[?25lK[?12l[?25h[?25le[?12l[?25h[?25le[?12l[?25h[?25lg[?12l[?25h[?25la[?12l[?25h[?25ln[?12l[?25h[?25l-[?12l[?25h[?25lM[?12l[?25h[?25la[?12l[?25h[?25ln[?12l[?25h[?25lg[?12l[?25h[?25la[?12l[?25h[?25lh[?12l[?25h[?25la[?12l[?25h[?25ls[?12l[?25h[?25l[22d(B[0;7mSave modified buffer?  (Answering "No" will DISCARD changes.)                   [23;1H Y(B[m Yes[K[24d(B[0;7m N(B[m No  [14G   (B[0;7m^C(B[m Cancel[K[22;63H[?12l[?25h[?25l[23d(B[0;7m^G(B[m Get Help[23;21H(B[0;7mM-D(B[m DOS Format[41G(B[0;7mM-A(B[m Append[23;61H(B[0;7mM-B(B[m Backup File[24d(B[0;7m^C(B[m Cancel[17G    (B[0;7mM-M(B[m Mac Format[41G(B[0;7mM-P(B[m Prepend[24;61H(B[0;7m^T(B[m To Files[22d(B[0;7mFile Name to Write: username.txt                             (B[m[22;33H[?12l[?25h[?25l[K[1;79H[1;71H(B[0;7m        (B[m[22;33H(B[0;7m[ Wrote 1 line ](B[m[J[24;80H[?12l[?25h[24;1H[?1049l[23;0;0t[?1l>mangahk@linux-07:~/Desktop/csci241/lab-1-Keegan-Mangahas$ git add [K username.txt
mangahk@linux-07:~/Desktop/csci241/lab-1-Keegan-Mangahas$ git cop,[K[K[Kommit -m "a[KAdded u sername.txt to f[K[K[K[K[K"
[master 5837424] Added username.txt
 1 file changed, 1 insertion(+)
 create mode 100644 username.txt
mangahk@linux-07:~/Desktop/csci241/lab-1-Keegan-Mangahas$ git checkout
Your branch is ahead of 'origin/master' by 3 commits.
  (use "git push" to publish your local commits)
mangahk@linux-07:~/Desktop/csci241/lab-1-Keegan-Mangahas$ git push
Username for 'https://github.com': Keegan-Mangahas
Password for 'https://Keegan-Mangahas@github.com': 
Counting objects: 9, done.
Delta compression using up to 8 threads.
Compressing objects:  16% (1/6)   Compressing objects:  33% (2/6)   Compressing objects:  50% (3/6)   Compressing objects:  66% (4/6)   Compressing objects:  83% (5/6)   Compressing objects: 100% (6/6)   Compressing objects: 100% (6/6), done.
Writing objects:  11% (1/9)   Writing objects:  22% (2/9)   Writing objects:  33% (3/9)   Writing objects:  44% (4/9)   Writing objects:  55% (5/9)   Writing objects:  66% (6/9)   Writing objects:  77% (7/9)   Writing objects:  88% (8/9)   Writing objects: 100% (9/9)   Writing objects: 100% (9/9), 812 bytes | 406.00 KiB/s, done.
Total 9 (delta 3), reused 0 (delta 0)
remote: Resolving deltas:   0% (0/3)[Kremote: Resolving deltas: 100% (3/3)[Kremote: Resolving deltas: 100% (3/3), completed with 1 local object.[K
To https://github.com/csci241-20s/lab-1-Keegan-Mangahas
   f81844e..5837424  master -> master
mangahk@linux-07:~/Desktop/csci241/lab-1-Keegan-Mangahas$ git checkout
Your branch is up to date with 'origin/master'.
mangahk@linux-07:~/Desktop/csci241/lab-1-Keegan-Mangahas$ git reset
mangahk@linux-07:~/Desktop/csci241/lab-1-Keegan-Mangahas$ git [K[K[K[Ktouch tempfile.txt
mangahk@linux-07:~/Desktop/csci241/lab-1-Keegan-Mangahas$ ls
build.gradle  settings.gradle  src  tempfile.txt  username.txt	writeup.txt
mangahk@linux-07:~/Desktop/csci241/lab-1-Keegan-Mangahas$ git rm tempfile.txt
fatal: pathspec 'tempfile.txt' did not match any files
mangahk@linux-07:~/Desktop/csci241/lab-1-Keegan-Mangahas$ mkdir tempfile[K[K[K[K[K[K[K[Ktestfile
mangahk@linux-07:~/Desktop/csci241/lab-1-Keegan-Mangahas$ ls
build.gradle	 src	       testfile      writeup.txt
settings.gradle  tempfile.txt  username.txt
mangahk@linux-07:~/Desktop/csci241/lab-1-Keegan-Mangahas$ git rm testfile
fatal: pathspec 'testfile' did not match any files
mangahk@linux-07:~/Desktop/csci241/lab-1-Keegan-Mangahas$ git rm
usage: git rm [<options>] [--] <file>...

    -n, --dry-run         dry run
    -q, --quiet           do not list removed files
    --cached              only remove from the index
    -f, --force           override the up-to-date check
    -r                    allow recursive removal
    --ignore-unmatch      exit with a zero status even if nothing matched

mangahk@linux-07:~/Desktop/csci241/lab-1-Keegan-Mangahas$ git rm testfile/
fatal: pathspec 'testfile/' did not match any files
mangahk@linux-07:~/Desktop/csci241/lab-1-Keegan-Mangahas$ git rm testfile/[K[K[K[K[K[K[K[K[K
usage: git rm [<options>] [--] <file>...

    -n, --dry-run         dry run
    -q, --quiet           do not list removed files
    --cached              only remove from the index
    -f, --force           override the up-to-date check
    -r                    allow recursive removal
    --ignore-unmatch      exit with a zero status even if nothing matched

mangahk@linux-07:~/Desktop/csci241/lab-1-Keegan-Mangahas$ git rm -r testfile/
fatal: pathspec 'testfile/' did not match any files
mangahk@linux-07:~/Desktop/csci241/lab-1-Keegan-Mangahas$ cd testfile/
mangahk@linux-07:~/Desktop/csci241/lab-1-Keegan-Mangahas/testfile$ git rm -r
usage: git rm [<options>] [--] <file>...

    -n, --dry-run         dry run
    -q, --quiet           do not list removed files
    --cached              only remove from the index
    -f, --force           override the up-to-date check
    -r                    allow recursive removal
    --ignore-unmatch      exit with a zero status even if nothing matched

mangahk@linux-07:~/Desktop/csci241/lab-1-Keegan-Mangahas/testfile$ cs k[Kla[K[Kte[K[K[K[Kd la[K[Ktestfile
bash: cd: testfile: No such file or directory
mangahk@linux-07:~/Desktop/csci241/lab-1-Keegan-Mangahas/testfile$ cd .
mangahk@linux-07:~/Desktop/csci241/lab-1-Keegan-Mangahas/testfile$ cd ..
mangahk@linux-07:~/Desktop/csci241/lab-1-Keegan-Mangahas$ git rm <testfile>
bash: syntax error near unexpected token `newline'
mangahk@linux-07:~/Desktop/csci241/lab-1-Keegan-Mangahas$ gu[Kit rm [K[K[K[K[K[K[Kls
build.gradle	 src	       testfile      writeup.txt
settings.gradle  tempfile.txt  username.txt
mangahk@linux-07:~/Desktop/csci241/lab-1-Keegan-Mangahas$ git rm temo[Kpfile.txt
fatal: pathspec 'tempfile.txt' did not match any files
mangahk@linux-07:~/Desktop/csci241/lab-1-Keegan-Mangahas$ l[Kgit status
On branch master
Your branch is up to date with 'origin/master'.

Untracked files:
  (use "git add <file>..." to include in what will be committed)

	[31mtempfile.txt[m

nothing added to commit but untracked files present (use "git add" to track)
mangahk@linux-07:~/Desktop/csci241/lab-1-Keegan-Mangahas$ git add
Nothing specified, nothing added.
Maybe you wanted to say 'git add .'?
mangahk@linux-07:~/Desktop/csci241/lab-1-Keegan-Mangahas$ git add tempfile.txt
mangahk@linux-07:~/Desktop/csci241/lab-1-Keegan-Mangahas$ git [K[K[K[Kls
build.gradle	 src	       testfile      writeup.txt
settings.gradle  tempfile.txt  username.txt
mangahk@linux-07:~/Desktop/csci241/lab-1-Keegan-Mangahas$ git pusjh[K[Kh
Username for 'https://github.com': Keegan-Mangahas
Password for 'https://Keegan-Mangahas@github.com': 
Everything up-to-date
mangahk@linux-07:~/Desktop/csci241/lab-1-Keegan-Mangahas$ git rm tee[Kmpfile.txt 
error: the following file has changes staged in the index:
    tempfile.txt
(use --cached to keep the file, or -f to force removal)
mangahk@linux-07:~/Desktop/csci241/lab-1-Keegan-Mangahas$ git rm tempfile.txt [1@- tempfile.txt  [A[C[C[C[C[C[C[C[C[C[C[C[C[C[C[C[C[C[C[C[C[C[C[C[C[C[C[C[C[C[C[C[C[C[C[C[C[C[C[C[C[C[C[C[C[C[C[C[C[C[C[C[C[C[C[C[C[C[C[C[C[C[C[C[C[C[Cftempfile.txt  [A[C[C[C[C[C[C[C[C[C[C[C[C[C[C[C[C[C[C[C[C[C[C[C[C[C[C[C[C[C[C[C[C[C[C[C[C[C[C[C[C[C[C[C[C[C[C[C[C[C[C[C[C[C[C[C[C[C[C[C[C[C[C[C[C[C[C[C tempfile.txt [A[C[C[C[C[C[C[C[C[C[C[C[C[C[C[C[C[C[C[C[C[C[C[C[C[C[C[C[C[C[C[C[C[C[C[C[C[C[C[C[C[C[C[C[C[C[C[C[C[C[C[C[C[C[C[C[C[C[C[C[C[C[C[C[C[C[C[Ctempfile.txt [K[A[C[C[C[C[C[C[C[C[C[C[C[C[C[C[C[C[C[C[C[C[C[C[C[C[C[C[C[C[C[C[C[C[C[C[C[C[C[C[C[C[C[C[C[C[C[C[C[C[C[C[C[C[C[C[C[C[C[C[C[C[C[C[C[C[C[C[Ctempfile.txt  [K[A[C[C[C[C[C[C[C[C[C[C[C[C[C[C[C[C[C[C[C[C[C[C[C[C[C[C[C[C[C[C[C[C[C[C[C[C[C[C[C[C[C[C[C[C[C[C[C[C[C[C[C[C[C[C[C[C[C[C[C[C[C[C[C[C[C[C[C[1P
[K[A[C[C[C[C[C[C[C[C[C[C[C[C[C[C[C[C[C[C[C[C[C[C[C[C[C[C[C[C[C[C[C[C[C[C[C[C[C[C[C[C[C[C[C[C[C[C[C[C[C[C[C[C[C[C[C[C[C[C[C[C[C[C[C[C[C[Cftempfile.txt  [A[C[C[C[C[C[C[C[C[C[C[C[C[C[C[C[C[C[C[C[C[C[C[C[C[C[C[C[C[C[C[C[C[C[C[C[C[C[C[C[C[C[C[C[C[C[C[C[C[C[C[C[C[C[C[C[C[C[C[C[C[C[C[C[C[C[C tempfile.txt  [A[C[C[C[C[C[C[C[C[C[C[C[C[C[C[C[C[C[C[C[C[C[C[C[C[C[C[C[C[C[C[C[C[C[C[C[C[C[C[C[C[C[C[C[C[C[C[C[C[C[C[C[C[C[C[C[C[C[C[C[C[C[C[C[C[C[C[C

rm 'tempfile.txt'
mangahk@linux-07:~/Desktop/csci241/lab-1-Keegan-Mangahas$ ls
build.gradle  settings.gradle  src  testfile  username.txt  writeup.txt
mangahk@linux-07:~/Desktop/csci241/lab-1-Keegan-Mangahas$ git r[Kmv testfile
usage: git mv [<options>] <source>... <destination>

    -v, --verbose         be verbose
    -n, --dry-run         dry run
    -f, --force           force move/rename even if target exists
    -k                    skip move/rename errors

mangahk@linux-07:~/Desktop/csci241/lab-1-Keegan-Mangahas$ git mv
usage: git mv [<options>] <source>... <destination>

    -v, --verbose         be verbose
    -n, --dry-run         dry run
    -f, --force           force move/rename even if target exists
    -k                    skip move/rename errors

mangahk@linux-07:~/Desktop/csci241/lab-1-Keegan-Mangahas$ git mv testfile/[K[K[K[K[K[K[K[K[K[K[K[K[K[K[K[Kgit blame
usage: git blame [<options>] [<rev-opts>] [<rev>] [--] <file>

    <rev-opts> are documented in git-rev-list(1)

    --incremental         Show blame entries as we find them, incrementally
    -b                    Show blank SHA-1 for boundary commits (Default: off)
    --root                Do not treat root commits as boundaries (Default: off)
    --show-stats          Show work cost statistics
    --progress            Force progress reporting
    --score-debug         Show output score for blame entries
    -f, --show-name       Show original filename (Default: auto)
    -n, --show-number     Show original linenumber (Default: off)
    -p, --porcelain       Show in a format designed for machine consumption
    --line-porcelain      Show porcelain format with per-line commit information
    -c                    Use the same output mode as git-annotate (Default: off)
    -t                    Show raw timestamp (Default: off)
    -l                    Show long commit SHA1 (Default: off)
    -s                    Suppress author name and timestamp (Default: off)
    -e, --show-email      Show author email instead of name (Default: off)
    -w                    Ignore whitespace differences
    --indent-heuristic    Use an experimental heuristic to improve diffs
    --minimal             Spend extra cycles to find better match
    -S <file>             Use revisions from <file> instead of calling git-rev-list
    --contents <file>     Use <file>'s contents as the final image
    -C[<score>]           Find line copies within and across files
    -M[<score>]           Find line movements within and across files
    -L <n,m>              Process only line range n,m, counting from 1
    --abbrev[=<n>]        use <n> digits to display SHA-1s

mangahk@linux-07:~/Desktop/csci241/lab-1-Keegan-Mangahas$ git blame writeup.txt  [A[C[C[C[C[C[C[C[C[C[C[C[C[C[C[C[C[C[C[C[C[C[C[C[C[C[C[C[C[C[C[C[C[C[C[C[C[C[C[C[C[C[C[C[C[C[C[C[C[C[C[C[C[C[C[C[C[C[C[C[C[C[C[C[C[C[C[C[C[C[C[C[C[C[C[C[C[C[C[C[K 
[?1h=aacffcef (Keegan 2020-04-08 19:00:08 -0700 1) Keegan Mangahas[m
3a501bf5 (Keegan 2020-04-08 19:02:43 -0700 2) Hobby: Playing guitar[m
[K[?1l>mangahk@linux-07:~/Desktop/csci241/lab-1-Keegan-Mangahas$ git log
[?1h=[33mcommit 58374241b8f48afd41d4dd582b5ed01b2f9ddd10[m[33m ([m[1;36mHEAD -> [m[1;32mmaster[m[33m, [m[1;31morigin/master[m[33m, [m[1;31m[m [33m[m[33m[m[1;36m[m[1;32m[m[33m[m[1;31m[m[33m[m[1;31morigin/HEAD[m[33m)[m[m
Author: Keegan <mangahk@wwu.edu>[m
Date:   Wed Apr 8 19:05:58 2020 -0700[m
[m
    Added username.txt[m
[m
[33mcommit 3a501bf54e4388e43f4abd0dc5b272e3a5069a6b[m[m
Author: Keegan <mangahk@wwu.edu>[m
Date:   Wed Apr 8 19:02:43 2020 -0700[m
[m
    Added part 2 (hobbies) to writeup[m
[m
[33mcommit aacffcef95f50dbb39f40fdf0a5df3fff472f83d[m[m
Author: Keegan <mangahk@wwu.edu>[m
Date:   Wed Apr 8 19:00:08 2020 -0700[m
[m
    Added part 1 (names) to writeup[m
[m
[33mcommit f81844e8d6d3a0ba48f30f6211e255b134d441e9[m[m
Author: Keegan <mangahk@wwu.edu>[m
Date:   Wed Apr 8 18:43:44 2020 -0700[m
[m
:[K[K[K:[K[K:[K[K[7mNo next tag  (press RETURN)[27m[24;1H[K[K:[K[K    Added empty writeup[m
[m
[33mcommit 8fb37697ff83ba37e29306da722defaa407e173b[m[m
Author: swehrwein <swehrwein@gmail.com>[m
Date:   Tue Apr 7 10:56:33 2020 -0700[m
[m
    Setting up GitHub Classroom Feedback[m
[m
[33mcommit ba739298b467efafbb33b1c769386ea3c6f02855[m[33m ([m[1;31morigin/feedback[m[33m)[m[m
Author: swehrwein <swehrwein@gmail.com>[m
Date:   Tue Apr 7 10:56:32 2020 -0700[m
[m
:[K[K[HM    Added part 2 (hobbies) to writeup[m
[HM[m
[HMDate:   Wed Apr 8 19:02:43 2020 -0700[m
[HMAuthor: Keegan <mangahk@wwu.edu>[m
[HM[33mcommit 3a501bf54e4388e43f4abd0dc5b272e3a5069a6b[m[m
[HM[m
[HM    Added username.txt[m
[HM[m
[HMDate:   Wed Apr 8 19:05:58 2020 -0700[m
[HMAuthor: Keegan <mangahk@wwu.edu>[m
[HM[33m[m[33m[m[1;36m[m[1;32m[m[33m[m[1;31m[m[33m[m[1;31morigin/HEAD[m[33m)[m[m
[HM[33mcommit 58374241b8f48afd41d4dd582b5ed01b2f9ddd10[m[33m ([m[1;36mHEAD -> [m[1;32mmaster[m[33m, [m[1;31morigin/master[m[33m, [m[1;31m[m[24;1H[K:[K[K:[K[K[7mNo next tag  (press RETURN)[27m[24;1H[K[K:[K[K:[K[K [KESCESC[K^J^J[K:[K[K    Added empty writeup[m
:[K[K:[K[K:[K[K:[K[K [K^X^X[K^?^?[K:[K[K:[K[K:[K[K:[K[K[m
:[K[K[33mcommit 8fb37697ff83ba37e29306da722defaa407e173b[m[m
Author: swehrwein <swehrwein@gmail.com>[m
Date:   Tue Apr 7 10:56:33 2020 -0700[m
[m
    Setting up GitHub Classroom Feedback[m
[m
[33mcommit ba739298b467efafbb33b1c769386ea3c6f02855[m[33m ([m[1;31morigin/feedback[m[33m)[m[m
Author: swehrwein <swehrwein@gmail.com>[m
Date:   Tue Apr 7 10:56:32 2020 -0700[m
[m
    Setting up GitHub Classroom Feedback[m
[m
:[K[K-[Klog file: [Kdd[K[K:[K[K:[K[K:[K[K:[K[K:[K[K[?1l>mangahk@linux-07:~/Desktop/csci241/lab-1-Keegan-Mangahas$ git diff
[?1h=[K[?1l>mangahk@linux-07:~/Desktop/csci241/lab-1-Keegan-Mangahas$ git diff writeup.txt 
[?1h=[K[?1l>mangahk@linux-07:~/Desktop/csci241/lab-1-Keegan-Mangahas$ git[K[K[Kls
build.gradle  settings.gradle  src  testfile  username.txt  writeup.txt
mangahk@linux-07:~/Desktop/csci241/lab-1-Keegan-Mangahas$ gi[K[Kgit status
On branch master
Your branch is up to date with 'origin/master'.

nothing to commit, working tree clean
mangahk@linux-07:~/Desktop/csci241/lab-1-Keegan-Mangahas$ git checkout -b questi on3
Switched to a new branch 'question3'
mangahk@linux-07:~/Desktop/csci241/lab-1-Keegan-Mangahas$ ls
build.gradle  settings.gradle  src  testfile  username.txt  writeup.txt
mangahk@linux-07:~/Desktop/csci241/lab-1-Keegan-Mangahas$ nano writeup.txt
[?1049h[22;0;0t[1;24r(B[m[4l[?7h[39;49m[?1h=[?1h=[?1h=[?25l[39;49m(B[m[H[2J[22;33H(B[0;7m[ Reading File ](B[m[22;39H(B[0;7m 2 lines ](B[m[H(B[0;7m  GNU nano 2.9.3                     writeup.txt                                [1;79H(B[m[23d(B[0;7m^G(B[m Get Help  (B[0;7m^O(B[m Write Out (B[0;7m^W(B[m Where Is  (B[0;7m^K(B[m Cut Text  (B[0;7m^J(B[m Justify   (B[0;7m^C(B[m Cur Pos[24d(B[0;7m^X(B[m Exit[14G(B[0;7m^R(B[m Read File (B[0;7m^\(B[m Replace   (B[0;7m^U(B[m Uncut Text(B[0;7m^T(B[m To Spell  (B[0;7m^_(B[m Go To Line[22d[3d[39;49m(B[mKeegan Mangahas[4dHobby: Playing guitar[A[?12l[?25h[?25l[4d[?12l[?25h[?25l[5d[?12l[?25h[?25l[1;71H(B[0;7mModified(B[m[5dF[?12l[?25h[?25la[?12l[?25h[?25lv[?12l[?25h[?25lo[?12l[?25h[?25lr[?12l[?25h[?25li[?12l[?25h[?25lt[?12l[?25h[?25le[?12l[?25h[?25l [?12l[?25h[?25ls[?12l[?25h[?25lo[?12l[?25h[?25ln[?12l[?25h[?25lg[?12l[?25h[?25lf[?12l[?25h[?25l [?12l[?25h[?25l:[?12l[?25h[?25l [?12l[?25h[?25lT[?12l[?25h[?25lh[?12l[?25h[?25le[?12l[?25h[?25l [?12l[?25h[?25lm[?12l[?25h[?25lo[?12l[?25h[?25ld[22d[K[5;23H[?12l[?25h[?25l [?12l[?25h[?25l [?12l[?25h[?25l [?12l[?25h[?25lM[?12l[?25h[?25lo[?12l[?25h[?25ld[?12l[?25h[?25le[?12l[?25h[?25lr[?12l[?25h[?25ln[?12l[?25h[?25l [?12l[?25h[?25lA[?12l[?25h[?25lg[?12l[?25h[?25le[?12l[?25h[?25l [?12l[?25h[?25lb[?12l[?25h[?25ly[?12l[?25h[?25l [?12l[?25h[?25lT[?12l[?25h[?25lh[?12l[?25h[?25le[?12l[?25h[?25l [?12l[?25h[?25lS[?12l[?25h[?25lt[?12l[?25h[?25lr[?12l[?25h[?25lo[?12l[?25h[?25lk[?12l[?25h[?25le[?12l[?25h[?25ls[?12l[?25h[?25l[22d(B[0;7mSave modified buffer?  (Answering "No" will DISCARD changes.)                   [23;1H Y(B[m Yes[K[24d(B[0;7m N(B[m No  [14G   (B[0;7m^C(B[m Cancel[K[22;63H[?12l[?25h[?25l[23d(B[0;7m^G(B[m Get Help[23;21H(B[0;7mM-D(B[m DOS Format[41G(B[0;7mM-A(B[m Append[23;61H(B[0;7mM-B(B[m Backup File[24d(B[0;7m^C(B[m Cancel[17G    (B[0;7mM-M(B[m Mac Format[41G(B[0;7mM-P(B[m Prepend[24;61H(B[0;7m^T(B[m To Files[22d(B[0;7mFile Name to Write: writeup.txt                              (B[m[22;32H[?12l[?25h[?25l[K[1;79H[1;71H(B[0;7m        (B[m[22;32H(B[0;7m[ Wrote 3 lines ](B[m[J[24;80H[?12l[?25h[24;1H[?1049l[23;0;0t[?1l>mangahk@linux-07:~/Desktop/csci241/lab-1-Keegan-Mangahas$ git add writeup.txt
mangahk@linux-07:~/Desktop/csci241/lab-1-Keegan-Mangahas$ git commit -u "Added f avorite so[Kong/artist to writeup.txt"
error: pathspec 'Added favorite song/artist to writeup.txt' did not match any file(s) known to git.
mangahk@linux-07:~/Desktop/csci241/lab-1-Keegan-Mangahas$ git commit -u "Added faavorite song/artist to writeup.txt"[A[C[C[C[C[C[C[C[C[C[C[C[C[C[C[C[C[C[C[C[C[C[C[C[C[C[C[C[C[C[C[C[C[C[C[C[C[C[C[C[C[C[C[C[C[C[C[C[C[C[C[C[C[C[C[C[C[C[C[C[C[C[C[C[C[C[C[C[C[C[C[C[C[C[C[C[C[C[C[C "Added fav[1P[A[C[C[C[C[C[C[C[C[C[C[C[C[C[C[C[C[C[C[C[C[C[C[C[C[C[C[C[C[C[C[C[C[C[C[C[C[C[C[C[C[C[C[C[C[C[C[C[C[C[C[C[C[C[C[C[C[C[C[C[C[C[C[C[C[C[C[C[C[Cm "Added fa[1@v[A[C[C[C[C[C[C[C[C[C[C[C[C[C[C[C[C[C[C[C[C[C[C[C[C[C[C[C[C[C[C[C[C[C[C[C[C[C[C[C[C[C[C[C[C[C[C[C[C[C[C[C[C[C[C[C[C[C[C[C[C[C[C[C[C[C[C[C[C[C

[question3 3b814b0] Added favorite song/artist to writeup.txt
 1 file changed, 1 insertion(+)
mangahk@linux-07:~/Desktop/csci241/lab-1-Keegan-Mangahas$ git checkout master
Switched to branch 'master'
Your branch is up to date with 'origin/master'.
mangahk@linux-07:~/Desktop/csci241/lab-1-Keegan-Mangahas$ git merge question3
Updating 5837424..3b814b0
Fast-forward
 writeup.txt | 1 [32m+[m
 1 file changed, 1 insertion(+)
mangahk@linux-07:~/Desktop/csci241/lab-1-Keegan-Mangahas$ git branch -d question 3
Deleted branch question3 (was 3b814b0).
mangahk@linux-07:~/Desktop/csci241/lab-1-Keegan-Mangahas$ git push
Username for 'https://github.com': Keegan-Mangahas
Password for 'https://Keegan-Mangahas@github.com': 
Counting objects: 3, done.
Delta compression using up to 8 threads.
Compressing objects:  33% (1/3)   Compressing objects:  66% (2/3)   Compressing objects: 100% (3/3)   Compressing objects: 100% (3/3), done.
Writing objects:  33% (1/3)   Writing objects:  66% (2/3)   Writing objects: 100% (3/3)   Writing objects: 100% (3/3), 349 bytes | 349.00 KiB/s, done.
Total 3 (delta 1), reused 0 (delta 0)
remote: Resolving deltas:   0% (0/1)[Kremote: Resolving deltas: 100% (1/1)[Kremote: Resolving deltas: 100% (1/1), completed with 1 local object.[K
To https://github.com/csci241-20s/lab-1-Keegan-Mangahas
   5837424..3b814b0  master -> master
mangahk@linux-07:~/Desktop/csci241/lab-1-Keegan-Mangahas$ lw
lw: command not found
mangahk@linux-07:~/Desktop/csci241/lab-1-Keegan-Mangahas$ ls
build.gradle  settings.gradle  src  testfile  username.txt  writeup.txt
mangahk@linux-07:~/Desktop/csci241/lab-1-Keegan-Mangahas$ cd src/main/java/lab1
mangahk@linux-07:~/Desktop/csci241/lab-1-Keegan-Mangahas/src/main/java/lab1$ ls
Hello.java
mangahk@linux-07:~/Desktop/csci241/lab-1-Keegan-Mangahas/src/main/java/lab1$ gra de bu[Kuild

Command 'grade' not found, did you mean:

  command 'glade' from snap glade (3.20.0.1)
  command 'grape' from snap groovy (3.0.1)
  command 'grads' from deb grads
  command 'grace' from deb grace
  command 'glade' from deb glade
  command 'gradle' from deb gradle

See 'snap info <snapname>' for additional versions.

mangahk@linux-07:~/Desktop/csci241/lab-1-Keegan-Mangahas/src/main/java/lab1$ gra dlebui[K[K [K[K build

Welcome to Gradle 6.1!

Here are the highlights of this release:
 - Dependency cache is relocatable
 - Configurable compilation order between Groovy, Java & Scala
 - New sample projects in Gradle's documentation

For more details see https://docs.gradle.org/6.1/release-notes.html

Starting a Gradle Daemon (subsequent builds will be faster)


[2A[1B[1m> Starting Daemon[m[17D[1B[1A[1m> Starting Daemon > Connecting to Daemon[m[40D[1B[1A> IDLE[0K[6D[1B[2A[1m<[0;1m-------------> 0% INITIALIZING [102ms][m[39D[1B[1m> Evaluating settings[m[21D[1B[2A[1m<[0;1m-------------> 0% INITIALIZING [203ms][m[39D[2B[2A[1m<[0;1m-------------> 0% INITIALIZING [303ms][m[39D[2B[2A[1m<[0;1m-------------> 0% INITIALIZING [403ms][m[39D[2B[2A[1m<[0;1m-------------> 0% INITIALIZING [503ms][m[39D[2B[2A[1m<[0;1m-------------> 0% INITIALIZING [603ms][m[39D[2B[2A[1m<[0;1m-------------> 0% INITIALIZING [703ms][m[39D[2B[2A[1m<[0;1m-------------> 0% INITIALIZING [803ms][m[39D[2B[2A[1m<[0;1m-------------> 0% INITIALIZING [903ms][m[39D[1B[1m> Evaluating settings > Compiling /home/mangahk/Desktop/csci241/lab-1-Keegan-Ma[m[79D[1B[2A[1m<[0;1m-------------> 0% INITIALIZING [1s][m[0K[36D[1B[1m> Evaluating settings[m[0K[21D[1B[1A[1m> Evaluating settings > Compiling /home/mangahk/Desktop/csci241/lab-1-Keegan-Ma[m[79D[1B[1A[1m> Evaluating settings[m[0K[21D[1B[2A[0K
[31mFAILURE: [39m[31mBuild failed with an exception.[39m

* What went wrong:
Project directory '/home/mangahk/Desktop/csci241/lab-1-Keegan-Mangahas/src/main/java/lab1' is not part of the build defined by settings file '/home/mangahk/Desktop/csci241/lab-1-Keegan-Mangahas/settings.gradle'. If this is an unrelated build, it must have its own settings file.

* Try:
Run with [1m--stacktrace[m option to get the stack trace. Run with [1m--info[m or [1m--debug[m option to get more log output. Run with [1m--scan[m to get full insights.

* Get more help at [1mhttps://help.gradle.org[m

[31;1mBUILD FAILED[0;39m in 6s
[0K
[0K
[2A[1m<[0;1m-------------> 0% WAITING[m[26D[1B[1m> Deleting unused version-specific caches in /home/mangahk/Desktop/csci241/lab-[m[79D[1B[2A[2K[1B[2K[1A[0m[?12l[?25hmangahk@linux-07:~/Desktop/csci241/lab-1-Keegan-Mangahas/src/main/java/lab1$ g[Kg[Kgra d;le[K[K[Kle run

[1A
[31mFAILURE: [39m[31mBuild failed with an exception.[39m

* What went wrong:
Project directory '/home/mangahk/Desktop/csci241/lab-1-Keegan-Mangahas/src/main/java/lab1' is not part of the build defined by settings file '/home/mangahk/Desktop/csci241/lab-1-Keegan-Mangahas/settings.gradle'. If this is an unrelated build, it must have its own settings file.

* Try:
Run with [1m--stacktrace[m option to get the stack trace. Run with [1m--info[m or [1m--debug[m option to get more log output. Run with [1m--scan[m to get full insights.

* Get more help at [1mhttps://help.gradle.org[m

[31;1mBUILD FAILED[0;39m in 546ms

[1A[1m<[0;1m-------------> 0% WAITING[m[26D[1B[1A[2K[0m[?12l[?25hmangahk@linux-07:~/Desktop/csci241/lab-1-Keegan-Mangahas/src/main/java/lab1$ ls[K[Kls
gradle	Hello.java
mangahk@linux-07:~/Desktop/csci241/lab-1-Keegan-Mangahas/src/main/java/lab1$ cd  HYell[K[K[K[Kello.java
bash: cd: Hello.java: Not a directory
mangahk@linux-07:~/Desktop/csci241/lab-1-Keegan-Mangahas/src/main/java/lab1$ gra dle build H[KHello.java


[2A[1m<[0;1m-------------> 0% INITIALIZING [12ms][m[38D[1B[1m> Evaluating settings[m[21D[1B[2A[0K
[31mFAILURE: [39m[31mBuild failed with an exception.[39m

* What went wrong:
Project directory '/home/mangahk/Desktop/csci241/lab-1-Keegan-Mangahas/src/main/java/lab1' is not part of the build defined by settings file '/home/mangahk/Desktop/csci241/lab-1-Keegan-Mangahas/settings.gradle'. If this is an unrelated build, it must have its own settings file.

* Try:
Run with [1m--stacktrace[m option to get the stack trace. Run with [1m--info[m or [1m--debug[m option to get more log output. Run with [1m--scan[m to get full insights.

* Get more help at [1mhttps://help.gradle.org[m

[31;1mBUILD FAILED[0;39m in 519ms
[0K
[0K
[2A[1m<[0;1m-------------> 0% WAITING[m[26D[1B[1m> Evaluating settings[m[21D[1B[2A[2K[1B[2K[1A[0m[?12l[?25hmangahk@linux-07:~/Desktop/csci241/lab-1-Keegan-Mangahas/src/main/java/lab1$ cd  ..
mangahk@linux-07:~/Desktop/csci241/lab-1-Keegan-Mangahas/src/main/java$ cd ...
bash: cd: ...: No such file or directory
mangahk@linux-07:~/Desktop/csci241/lab-1-Keegan-Mangahas/src/main/java$ cd .[K[K.

Command 'cd.' not found, did you mean:

  command 'cd5' from deb cd5
  command 'cdp' from deb irpas
  command 'cdb' from deb tinycdb
  command 'cdo' from deb cdo
  command 'cdi' from deb cdo
  command 'cdv' from deb codeville
  command 'cdw' from deb cdw
  command 'cde' from deb cde

Try: apt install <deb name>

mangahk@linux-07:~/Desktop/csci241/lab-1-Keegan-Mangahas/src/main/java$ cd ..
mangahk@linux-07:~/Desktop/csci241/lab-1-Keegan-Mangahas/src/main$ cd ..
mangahk@linux-07:~/Desktop/csci241/lab-1-Keegan-Mangahas/src$ cd ..
mangahk@linux-07:~/Desktop/csci241/lab-1-Keegan-Mangahas$ gradle bvu[K[Kuild


[2A[1m<[0;1m-------------> 0% INITIALIZING [6ms][m[37D[1B[1m> Evaluating settings[m[21D[1B[2A[1m<[0;1m-------------> 0% CONFIGURING [106ms][m[38D[1B[1m> Loading projects[m[0K[18D[1B[2A[1m<[0;1m-------------> 0% CONFIGURING [206ms][m[38D[1B[1m> root project[m[0K[14D[1B[2A[1m<[0;1m-------------> 0% CONFIGURING [306ms][m[38D[2B[2A[1m<[0;1m-------------> 0% CONFIGURING [406ms][m[38D[2B[2A[1m<[0;1m-------------> 0% CONFIGURING [506ms][m[38D[2B[2A[1m<[0;1m-------------> 0% CONFIGURING [606ms][m[38D[2B[2A[1m<[0;1m-------------> 0% CONFIGURING [706ms][m[38D[2B[2A[1m<[0;1m-------------> 0% CONFIGURING [806ms][m[38D[2B[2A[1m<[0;1m-------------> 0% CONFIGURING [906ms][m[38D[1B[1m> root project > Compiling /home/mangahk/Desktop/csci241/lab-1-Keegan-Mangahas/[m[79D[1B[2A[1m<[0;1m-------------> 0% CONFIGURING [1s][m[0K[35D[1B[1m> root project[m[0K[14D[1B[2A[1m<[0;32;1m=============[0;39;1m> 100% CONFIGURING [1s][m[37D[1B> IDLE[0K[6D[1B[2A[1m<[0;1m-------------> 0% EXECUTING [1s][m[0K[33D[2B[1A[1m> :compileJava[m[14D[1B[1A[1m> :compileJava > Resolve dependencies of :compileClasspath[m[58D[1B[1A[1m> :compileJava > Resolve dependencies of :compileClasspath > guava-26.0-jre.pom[m[79D[1B[2A[1m<[0;1m-------------> 0% EXECUTING [2s][m[33D[2B[1A[1m> :compileJava > Resolve dependencies of :compileClasspath[m[0K[58D[1B[1A[1m> :compileJava > Resolve dependencies of :compileClasspath > oss-parent-9.pom[m[77D[1B[2A[1m<[0;1m-------------> 0% EXECUTING [3s][m[33D[1B[1m> :compileJava > Resolve dependencies of :compileClasspath[m[0K[58D[1B


[4A[1m> :compileJava > Resolve dependencies of :compileClasspath > checker-qual-2.5.2[m[79D[1B[1m> :compileJava > Resolve dependencies of :compileClasspath > animal-sniffer-ann[m[79D[1B[1m> :compileJava > Resolve dependencies of :compileClasspath > error_prone_annota[m[79D[1B[1m> :compileJava > Resolve dependencies of :compileClasspath > jsr305-3.0.2.pom[m[77D[1B[4A> IDLE[0K[6D[1B> IDLE[0K[6D[1B[1m> :compileJava > Resolve dependencies of :compileClasspath > mojo-parent-34.pom[m[79D[1B> IDLE[0K[6D[1B[2A[1m> :compileJava > Resolve dependencies of :compileClasspath[m[0K[58D[2B[3A[1m> :compileJava > Resolve files of :compileClasspath > error_prone_annotations-2[m[79D[1B[1m> :compileJava > Resolve files of :compileClasspath > checker-qual-2.5.2.jar > [m[79D[1B[1m> :compileJava > Resolve files of :compileClasspath > guava-26.0-jre.jar[m[72D[1B[3A> IDLE[0K[6D[1B> IDLE[0K[6D[1B[1m> :compileJava > Resolve files of :compileClasspath > guava-26.0-jre.jar > 1.31[m[79D[1B[1A[1m> :compileJava > Resolve files of :compileClasspath[m[0K[51D[1B[1A[1m> :compileJava[m[0K[14D[1B[5A[1m<[0;1m-------------> 0% EXECUTING [4s][m[33D[5B[5A[1m<[0;1m-------------> 0% EXECUTING [5s][m[33D[5B[5A[1m<[0;1m-------------> 0% EXECUTING [6s][m[33D[5B[5A[1m<[0;1m-------------> 0% EXECUTING [7s][m[33D[5B[5A[1m<[0;32;1m===[0;39;1m----------> 28% EXECUTING [7s][m[34D[4B[1m> :startScripts[m[15D[1B[5A[1m<[0;32;1m====[0;39;1m---------> 35% EXECUTING [8s][m[34D[4B[1m> :distTar[m[0K[10D[1B[5A[1m<[0;32;1m=====[0;39;1m--------> 42% EXECUTING [8s][m[34D[4B[1m> :distZip[m[10D[1B[5A[1m<[0;32;1m============[0;39;1m-> 92% EXECUTING [8s][m[34D[4B> IDLE[0K[6D[1B[5A[0K
[32;1mBUILD SUCCESSFUL[0;39m in 8s
5 actionable tasks: 5 executed
[2B[0K
[0K
[0K
[5A[1m<[0;1m-------------> 0% WAITING[m[26D[1B> IDLE[6D[1B> IDLE[6D[1B> IDLE[6D[1B> IDLE[6D[1B[5A[2K[1B[2K[1B[2K[1B[2K[1B[2K[4A[0m[?12l[?25hmangahk@linux-07:~/Desktop/csci241/lab-1-Keegan-Mangahas$ gradel[K[Kle run


[2A[1m<[0;1m-------------> 0% EXECUTING [95ms][m[35D[1B[1m> :compileJava > Resolve files of :compileClasspath[m[51D[1B[2A[1m<[0;32;1m=========[0;39;1m----> 75% EXECUTING [195ms][m[37D[1B[1m> :run[m[0K[6D[1B[2A[0K
[1m> Task :run[m
Hello, world!

[32;1mBUILD SUCCESSFUL[0;39m in 734ms
2 actionable tasks: 1 executed, 1 up-to-date
[0K
[0K
[2A[1m<[0;1m-------------> 0% WAITING[m[26D[1B[1m> :run[m[6D[1B[2A[2K[1B[2K[1A[0m[?12l[?25hmangahk@linux-07:~/Desktop/csci241/lab-1-Keegan-Mangahas$ nano src/main/java/lab11/hello.jav[K[K[K[K[K[K[K[K[KHello.java 
[?1049h[22;0;0t[1;24r(B[m[4l[?7h[39;49m[?1h=[?1h=[?1h=[?25l[39;49m(B[m[H[2J[22;33H(B[0;7m[ Reading File ](B[m[22;39H(B[0;7m 7 lines ](B[m[H(B[0;7m  GNU nano 2.9.3            src/main/java/lab1/Hello.java                       [1;79H(B[m[23d(B[0;7m^G(B[m Get Help  (B[0;7m^O(B[m Write Out (B[0;7m^W(B[m Where Is  (B[0;7m^K(B[m Cut Text  (B[0;7m^J(B[m Justify   (B[0;7m^C(B[m Cur Pos[24d(B[0;7m^X(B[m Exit[14G(B[0;7m^R(B[m Read File (B[0;7m^\(B[m Replace   (B[0;7m^U(B[m Uncut Text(B[0;7m^T(B[m To Spell  (B[0;7m^_(B[m Go To Line[22d[3d[39;49m[36mpackage[39m(B[m lab1;[5d[36mpublic[39m(B[m [36mclass[39m(B[m Hello {[6;3H[36mpublic[39m(B[m [36mstatic[39m(B[m [32mvoid[39m(B[m main(String[] args) {[7;5HSystem.out.println([31m"Hello, world!"[39m(B[m);[8;3H}[9d}[3d[?12l[?25h[?25l[?12l[?25h[?25l[?12l[?25h[?25l[?12l[?25h[?25l[4d[?12l[?25h[?25l[5d[?12l[?25h[?25l[6d[?12l[?25h[?25l [?12l[?25h[?25l [?12l[?25h[?25l[C[?12l[?25h[?25l[C[?12l[?25h[?25l[C[?12l[?25h[?25l[C[?12l[?25h[?25l[C[?12l[?25h[?25l[C[?12l[?25h[?25l [?12l[?25h[?25l[C[?12l[?25h[?25l[C[?12l[?25h[?25l[C[?12l[?25h[?25l[C[?12l[?25h[?25l[C[?12l[?25h[?25l[C[?12l[?25h[?25l [?12l[?25h[?25l[C[?12l[?25h[?25l[C[?12l[?25h[?25l[C[?12l[?25h[?25l[22d[K[6;21H[?12l[?25h[?25l [?12l[?25h[?25lm[?12l[?25h[?25la[?12l[?25h[?25li[?12l[?25h[?25ln[?12l[?25h[?25l([?12l[?25h[?25lS[?12l[?25h[?25lt[?12l[?25h[?25lr[?12l[?25h[?25li[?12l[?25h[?25ln[?12l[?25h[?25lg[?12l[?25h[?25l[[?12l[?25h[?25l][?12l[?25h[?25l [?12l[?25h[?25la[?12l[?25h[?25lr[?12l[?25h[?25lg[?12l[?25h[?25l[7d[?12l[?25h[?25l[1;71H(B[0;7mModified(B[m[7;24H"Hello, world!);[K[?12l[?25h[?25l);[K[?12l[?25h[?25l);[K[?12l[?25h[?25l);[K[?12l[?25h[?25l);[K[?12l[?25h[?25l);[K[?12l[?25h[?25l);[K[?12l[?25h[?25l);[K[?12l[?25h[?25l[24G[31m"Hello,"[39m(B[m);[?12l[?25h[?25l[7;24H"Hello,);[K[?12l[?25h[?25l );[?12l[?25h[?25l[7;24H[31m"Hello, "[39m(B[m);[?12l[?25h[?25l );[?12l[?25h[?25ll);[?12l[?25h[?25la);[?12l[?25h[?25l);[K[?12l[?25h[?25l);[K[?12l[?25h[?25l);[K[?12l[?25h[?25l );[?12l[?25h[?25l+);[?12l[?25h[?25l );[?12l[?25h[?25ll);[?12l[?25h[?25la);[?12l[?25h[?25lb);[?12l[?25h[?25l1);[?12l[?25h[?25l)[?12l[?25h[?25l;[?12l[?25h[?25l*[?12l[?25h[?25l [?12l[?25h[?25l[?12l[?25h[?25l[?12l[?25h[?25l);[K[?12l[?25h[?25l);[K[?12l[?25h[?25l);[K[?12l[?25h[?25l);[K[?12l[?25h[?25l*);[?12l[?25h[?25la);[?12l[?25h[?25lr);[?12l[?25h[?25lg);[?12l[?25h[?25lv);[?12l[?25h[?25l[);[?12l[?25h[?25l]);[?12l[?25h[?25l);[K[?12l[?25h[?25l);[K[?12l[?25h[?25l);[K[?12l[?25h[?25l);[K[?12l[?25h[?25l);[K[?12l[?25h[?25l);[K[?12l[?25h[?25l);[K[?12l[?25h[?25la);[?12l[?25h[?25lr);[?12l[?25h[?25lg);[?12l[?25h[?25ls);[?12l[?25h[?25l[22d(B[0;7mSave modified buffer?  (Answering "No" will DISCARD changes.)                   [23;1H Y(B[m Yes[K[24d(B[0;7m N(B[m No  [14G   (B[0;7m^C(B[m Cancel[K[22;63H[?12l[?25h[?25l[23d(B[0;7m^G(B[m Get Help[23;21H(B[0;7mM-D(B[m DOS Format[41G(B[0;7mM-A(B[m Append[23;61H(B[0;7mM-B(B[m Backup File[24d(B[0;7m^C(B[m Cancel[17G    (B[0;7mM-M(B[m Mac Format[41G(B[0;7mM-P(B[m Prepend[24;61H(B[0;7m^T(B[m To Files[22d(B[0;7mFile Name to Write: src/main/java/lab1/Hello.java            (B[m[22;50H[?12l[?25h[?25l[K[1;79H[1;71H(B[0;7m        (B[m[22;32H(B[0;7m[ Wrote 7 lines ](B[m[J[24;80H[?12l[?25h[24;1H[?1049l[23;0;0t[?1l>mangahk@linux-07:~/Desktop/csci241/lab-1-Keegan-Mangahas$ c[Kgradle build


[2A[1m<[0;1m-------------> 0% EXECUTING [99ms][m[35D[1B[1m> :compileJava[m[14D[1B[2A[1m<[0;1m-------------> 0% EXECUTING [199ms][m[36D[2B[2A[1m<[0;1m-------------> 0% EXECUTING [299ms][m[36D[2B[2A[1m<[0;32;1m====[0;39;1m---------> 35% EXECUTING [399ms][m[37D[1B[1m> :distTar[m[0K[10D[1B[2A[1m<[0;32;1m=====[0;39;1m--------> 42% EXECUTING [499ms][m[37D[1B[1m> :distZip[m[10D[1B[2A[0K
[32;1mBUILD SUCCESSFUL[0;39m in 1s
5 actionable tasks: 4 executed, 1 up-to-date
[0K
[0K
[2A[1m<[0;1m-------------> 0% WAITING[m[26D[1B> IDLE[6D[1B[2A[2K[1B[2K[1A[0m[?12l[?25hmangahk@linux-07:~/Desktop/csci241/lab-1-Keegan-Mangahas$ gradle run --args=":[K241 1[K[A[C[C[C[C[C[C[C[C[C[C[C[C[C[C[C[C[C[C[C[C[C[C[C[C[C[C[C[C[C[C[C[C[C[C[C[C[C[C[C[C[C[C[C[C[C[C[C[C[C[C[C[C[C[C[C[C[C[C[C[C[C[C[C[C[C[C[C[C[C[C[C[C[C[C[C[C[C[C[C[K
[K[A[C[C[C[C[C[C[C[C[C[C[C[C[C[C[C[C[C[C[C[C[C[C[C[C[C[C[C[C[C[C[C[C[C[C[C[C[C[C[C[C[C[C[C[C[C[C[C[C[C[C[C[C[C[C[C[C[C[C[C[C[C[C[C[C[C[C[C[C[C[C[C[C[C[C[C[C[C[C[C1 "


[2A[1m<[0;1m-------------> 0% INITIALIZING [14ms][m[38D[1B[1m> Evaluating settings[m[21D[1B[2A[1m<[0;32;1m=========[0;39;1m----> 75% EXECUTING [114ms][m[0K[37D[1B[1m> :run[m[0K[6D[1B[2A[0K
[1m> Task :run[m
Hello, [Ljava.lang.String;@24d46ca6

[32;1mBUILD SUCCESSFUL[0;39m in 680ms
2 actionable tasks: 1 executed, 1 up-to-date
[0K
[0K
[2A[1m<[0;1m-------------> 0% WAITING[m[26D[1B> IDLE[6D[1B[2A[2K[1B[2K[1A[0m[?12l[?25hmangahk@linux-07:~/Desktop/csci241/lab-1-Keegan-Mangahas$ gradle run --args="241""[A[C[C[C[C[C[C[C[C[C[C[C[C[C[C[C[C[C[C[C[C[C[C[C[C[C[C[C[C[C[C[C[C[C[C[C[C[C[C[C[C[C[C[C[C[C[C[C[C[C[C[C[C[C[C[C[C[C[C[C[C[C[C[C[C[10Pbuild
[K[A[C[C[C[C[C[C[C[C[C[C[C[C[C[C[C[C[C[C[C[C[C[C[C[C[C[C[C[C[C[C[C[C[C[C[C[C[C[C[C[C[C[C[C[C[C[C[C[C[C[C[C[C[C[C[C[C[C[C[C[C[C[C[C[C[C[C[C[C[C[Cnano src/main/java/lab11/Hello.java 
[?1049h[22;0;0t[1;24r(B[m[4l[?7h[39;49m[?1h=[?1h=[?1h=[?25l[39;49m(B[m[H[2J[22;33H(B[0;7m[ Reading File ](B[m[22;39H(B[0;7m 7 lines ](B[m[H(B[0;7m  GNU nano 2.9.3            src/main/java/lab1/Hello.java                       [1;79H(B[m[23d(B[0;7m^G(B[m Get Help  (B[0;7m^O(B[m Write Out (B[0;7m^W(B[m Where Is  (B[0;7m^K(B[m Cut Text  (B[0;7m^J(B[m Justify   (B[0;7m^C(B[m Cur Pos[24d(B[0;7m^X(B[m Exit[14G(B[0;7m^R(B[m Read File (B[0;7m^\(B[m Replace   (B[0;7m^U(B[m Uncut Text(B[0;7m^T(B[m To Spell  (B[0;7m^_(B[m Go To Line[22d[3d[39;49m[36mpackage[39m(B[m lab1;[5d[36mpublic[39m(B[m [36mclass[39m(B[m Hello {[6;3H[36mpublic[39m(B[m [36mstatic[39m(B[m [32mvoid[39m(B[m main(String[] args) {[7;5HSystem.out.println([31m"Hello, "[39m(B[m + args);[8;3H}[9d}[3d[?12l[?25h[?25l[4d[?12l[?25h[?25l[5d[?12l[?25h[?25l[C[?12l[?25h[?25l[C[?12l[?25h[?25l[C[?12l[?25h[?25l[C[?12l[?25h[?25l[C[?12l[?25h[?25l[C[?12l[?25h[?25l [?12l[?25h[?25l[C[?12l[?25h[?25l[C[?12l[?25h[?25l[C[?12l[?25h[?25l[C[?12l[?25h[?25l[C[?12l[?25h[?25l [?12l[?25h[?25lH[?12l[?25h[?25le[?12l[?25h[?25ll[?12l[?25h[?25ll[?12l[?25h[?25l[6d[?12l[?25h[?25l[C[?12l[?25h[?25l[C[?12l[?25h[?25l[C[?12l[?25h[?25l [?12l[?25h[?25lm[?12l[?25h[?25l[22d[K[6;24H[?12l[?25h[?25li[?12l[?25h[?25ln[?12l[?25h[?25l([?12l[?25h[?25lS[?12l[?25h[?25lt[?12l[?25h[?25lr[?12l[?25h[?25li[?12l[?25h[?25ln[?12l[?25h[?25lg[?12l[?25h[?25l[[?12l[?25h[?25l][?12l[?25h[?25l [?12l[?25h[?25l[7d[?12l[?25h[?25l[8;4H[?12l[?25h[?25l[7;36H[?12l[?25h[?25la[?12l[?25h[?25lr[?12l[?25h[?25lg[?12l[?25h[?25ls[?12l[?25h[?25l[A[?12l[?25h[?25l[1;71H(B[0;7mModified(B[m[6;40H,) {[?12l[?25h[?25l ) {[?12l[?25h[?25lc) {[?12l[?25h[?25lh) {[?12l[?25h[?25la) {[?12l[?25h[?25l[32mchar[39m(B[m) {[?12l[?25h[?25l ) {[?12l[?25h[?25l*) {[?12l[?25h[?25la) {[?12l[?25h[?25lr) {[?12l[?25h[?25lg) {[?12l[?25h[?25lv) {[?12l[?25h[?25l{) {[?12l[?25h[?25l) {[K[?12l[?25h[?25l[) {[?12l[?25h[?25l]) {[?12l[?25h[?25l) {[K[?12l[?25h[?25l) {[K[?12l[?25h[?25l) {[K[?12l[?25h[?25l) {[K[?12l[?25h[?25l) {[K[?12l[?25h[?25l) {[K[?12l[?25h[?25l) {[K[?12l[?25h[?25l) {[K[?12l[?25h[?25lcha) {[K[?12l[?25h[?25l) {[K[?12l[?25h[?25l) {[K[?12l[?25h[?25l) {[K[?12l[?25h[?25l) {[K[?12l[?25h[?25l) {[K[?12l[?25h[?25l[?12l[?25h[?25l[7d[?12l[?25h[?25l[?12l[?25h[?25l[?12l[?25h[?25l[?12l[?25h[?25l[?12l[?25h[?25l[1P[?12l[?25h[?25l< args);[35G[?12l[?25h[?25l<< args);[36G[?12l[?25h[?25l[22d(B[0;7mSave modified buffer?  (Answering "No" will DISCARD changes.)                   [23;1H Y(B[m Yes[K[24d(B[0;7m N(B[m No  [14G   (B[0;7m^C(B[m Cancel[K[22;63H[?12l[?25h[?25l[23d(B[0;7m^G(B[m Get Help[23;21H(B[0;7mM-D(B[m DOS Format[41G(B[0;7mM-A(B[m Append[23;61H(B[0;7mM-B(B[m Backup File[24d(B[0;7m^C(B[m Cancel[17G    (B[0;7mM-M(B[m Mac Format[41G(B[0;7mM-P(B[m Prepend[24;61H(B[0;7m^T(B[m To Files[22d(B[0;7mFile Name to Write: src/main/java/lab1/Hello.java            (B[m[22;50H[?12l[?25h[?25l[K[1;79H[1;71H(B[0;7m        (B[m[22;32H(B[0;7m[ Wrote 7 lines ](B[m[J[24;80H[?12l[?25h[24;1H[?1049l[23;0;0t[?1l>mangahk@linux-07:~/Desktop/csci241/lab-1-Keegan-Mangahas$ nano src/main/java/lab11/Hello.java [A[C[C[C[C[C[C[C[C[C[C[C[C[C[C[C[C[C[C[C[C[C[C[C[C[C[C[C[C[C[C[C[C[C[C[C[C[C[C[C[C[C[C[C[C[Cgradle run --args="241"[K[A[C[C[C[C[C[C[C[C[C[C[C[C[C[C[C[C[C[C[C[C[C[C[C[C[C[C[C[C[C[C[C[C[C[C[C[C[C[C[C[C[C[C[C[C[C[C[C[C[C[C[C[C[C[C[C[C[C[C[C[C[C[C[C[C[10Pbuild
[K[A[C[C[C[C[C[C[C[C[C[C[C[C[C[C[C[C[C[C[C[C[C[C[C[C[C[C[C[C[C[C[C[C[C[C[C[C[C[C[C[C[C[C[C[C[C[C[C[C[C[C[C[C[C[C[C[C[C[C[C[C[C[C[C[C[C[C[C[C[C[C


[2A[1m<[0;1m-------------> 0% EXECUTING [104ms][m[36D[1B[1m> :compileJava[m[14D[1B[2A[0K
[31;1m> Task :compileJava[0;39m[31m FAILED[39m
/home/mangahk/Desktop/csci241/lab-1-Keegan-Mangahas/src/main/java/lab1/Hello.java:5: error: bad operand types for binary operator '<<'
    System.out.println("Hello, " << args);
                                 ^
  first type:  String
  second type: String[]
1 error

[31mFAILURE: [39m[31mBuild failed with an exception.[39m

* What went wrong:
Execution failed for task ':compileJava'.
[33m> [39mCompilation failed; see the compiler error output for details.

* Try:
Run with [1m--stacktrace[m option to get the stack trace. Run with [1m--info[m or [1m--debug[m option to get more log output. Run with [1m--scan[m to get full insights.

[0K
[0K
[2A[1m<[0;1m-------------> 7% EXECUTING [204ms][m[36D[1B> IDLE[6D[1B[2A* Get more help at [1mhttps://help.gradle.org[m
[0K
[31;1mBUILD FAILED[0;39m in 716ms
1 actionable task: 1 executed
[0K
[0K
[2A[1m<[0;1m-------------> 0% WAITING[m[26D[1B> IDLE[6D[1B[2A[2K[1B[2K[1A[0m[?12l[?25hmangahk@linux-07:~/Desktop/csci241/lab-1-Keegan-Mangahas$ gradle buildnano src/main/java/lab11/Hello.java 
[?1049h[22;0;0t[1;24r(B[m[4l[?7h[39;49m[?1h=[?1h=[?1h=[?25l[39;49m(B[m[H[2J[22;33H(B[0;7m[ Reading File ](B[m[22;39H(B[0;7m 7 lines ](B[m[H(B[0;7m  GNU nano 2.9.3            src/main/java/lab1/Hello.java                       [1;79H(B[m[23d(B[0;7m^G(B[m Get Help  (B[0;7m^O(B[m Write Out (B[0;7m^W(B[m Where Is  (B[0;7m^K(B[m Cut Text  (B[0;7m^J(B[m Justify   (B[0;7m^C(B[m Cur Pos[24d(B[0;7m^X(B[m Exit[14G(B[0;7m^R(B[m Read File (B[0;7m^\(B[m Replace   (B[0;7m^U(B[m Uncut Text(B[0;7m^T(B[m To Spell  (B[0;7m^_(B[m Go To Line[22d[3d[39;49m[36mpackage[39m(B[m lab1;[5d[36mpublic[39m(B[m [36mclass[39m(B[m Hello {[6;3H[36mpublic[39m(B[m [36mstatic[39m(B[m [32mvoid[39m(B[m main(String[] args) {[7;5HSystem.out.println([31m"Hello, "[39m(B[m << args);[8;3H}[9d}[3d[?12l[?25h[?25l[?12l[?25h[?25l[1;71H(B[0;7mModified(B[m[3d+[36mpackage[39m(B[m lab1;+[?12l[?25h[?25l[1P[?12l[?25h[?25l[4d[?12l[?25h[?25l[5d[?12l[?25h[?25l[6d[?12l[?25h[?25l[7d[?12l[?25h[?25l [?12l[?25h[?25l [?12l[?25h[?25l [?12l[?25h[?25l [?12l[?25h[?25lS[?12l[?25h[?25ly[?12l[?25h[?25ls[?12l[?25h[?25lt[?12l[?25h[?25le[?12l[?25h[?25lm[?12l[?25h[?25l.[?12l[?25h[?25lo[?12l[?25h[?25lu[?12l[?25h[?25lt[?12l[?25h[?25l.[?12l[?25h[?25lp[?12l[?25h[?25lr[?12l[?25h[?25li[?12l[?25h[?25l[22d[K[7;20H[?12l[?25h[?25lt[?12l[?25h[?25ll[?12l[?25h[?25ln[?12l[?25h[?25l([?12l[?25h[?25l[C[?12l[?25h[?25l[C[?12l[?25h[?25l[C[?12l[?25h[?25l[C[?12l[?25h[?25l[C[?12l[?25h[?25l[C[?12l[?25h[?25l[C[?12l[?25h[?25l[C[?12l[?25h[?25l[C[?12l[?25h[?25l [?12l[?25h[?25l<[?12l[?25h[?25l<[?12l[?25h[?25l [?12l[?25h[?25l[?12l[?25h[?25l[1P<[?12l[?25h[?25l[1P[?12l[?25h[?25l+ args);[35G[?12l[?25h[?25l[22d(B[0;7mSave modified buffer?  (Answering "No" will DISCARD changes.)                   [23;1H Y(B[m Yes[K[24d(B[0;7m N(B[m No  [14G   (B[0;7m^C(B[m Cancel[K[22;63H[?12l[?25h[?25l[23d(B[0;7m^G(B[m Get Help[23;21H(B[0;7mM-D(B[m DOS Format[41G(B[0;7mM-A(B[m Append[23;61H(B[0;7mM-B(B[m Backup File[24d(B[0;7m^C(B[m Cancel[17G    (B[0;7mM-M(B[m Mac Format[41G(B[0;7mM-P(B[m Prepend[24;61H(B[0;7m^T(B[m To Files[22d(B[0;7mFile Name to Write: src/main/java/lab1/Hello.java            (B[m[22;50H[?12l[?25h[?25l[K[1;79H[1;71H(B[0;7m        (B[m[22;32H(B[0;7m[ Wrote 7 lines ](B[m[J[24;80H[?12l[?25h[24;1H[?1049l[23;0;0t[?1l>mangahk@linux-07:~/Desktop/csci241/lab-1-Keegan-Mangahas$ nano src/main/java/lab11/Hello.java [A[C[C[C[C[C[C[C[C[C[C[C[C[C[C[C[C[C[C[C[C[C[C[C[C[C[C[C[C[C[C[C[C[C[C[C[C[C[C[C[C[C[C[C[C[C[10Pgradle build
[K[A[C[C[C[C[C[C[C[C[C[C[C[C[C[C[C[C[C[C[C[C[C[C[C[C[C[C[C[C[C[C[C[C[C[C[C[C[C[C[C[C[C[C[C[C[C[C[C[C[C[C[C[C[C[C[C[C[C[C[C[C[C[C[C[C[C[C[C[C[C[C


[2A[1m<[0;1m-------------> 0% CONFIGURING [20ms][m[37D[1B[1m> root project[m[14D[1B[2A[1m<[0;1m-------------> 0% EXECUTING [120ms][m[0K[36D[1B[1m> :compileJava[m[14D[1B[2A[0K
[32;1mBUILD SUCCESSFUL[0;39m in 642ms
5 actionable tasks: 1 executed, 4 up-to-date
[0K
[0K
[2A[1m<[0;1m-------------> 0% WAITING[m[26D[1B[1m> :compileJava[m[14D[1B[2A[2K[1B[2K[1A[0m[?12l[?25hmangahk@linux-07:~/Desktop/csci241/lab-1-Keegan-Mangahas$ gradle buildnano src/main/java/lab11/Hello.java [A[C[C[C[C[C[C[C[C[C[C[C[C[C[C[C[C[C[C[C[C[C[C[C[C[C[C[C[C[C[C[C[C[C[C[C[C[C[C[C[C[C[C[C[C[C[10Pgradle build
[K[A[C[C[C[C[C[C[C[C[C[C[C[C[C[C[C[C[C[C[C[C[C[C[C[C[C[C[C[C[C[C[C[C[C[C[C[C[C[C[C[C[C[C[C[C[C[C[C[C[C[C[C[C[C[C[C[C[C[C[C[C[C[C[C[C[C[C[C[C[C[Cnano src/main/java/lab11/Hello.java [A[C[C[C[C[C[C[C[C[C[C[C[C[C[C[C[C[C[C[C[C[C[C[C[C[C[C[C[C[C[C[C[C[C[C[C[C[C[C[C[C[C[C[C[C[Cgradle run --args="241"[K


[2A[1m<[0;32;1m=========[0;39;1m----> 75% EXECUTING [100ms][m[37D[1B[1m> :run[m[6D[1B[2A[0K
[1m> Task :run[m
Hello, [Ljava.lang.String;@24d46ca6

[32;1mBUILD SUCCESSFUL[0;39m in 675ms
2 actionable tasks: 1 executed, 1 up-to-date
[0K
[0K
[2A[1m<[0;1m-------------> 0% WAITING[m[26D[1B[1m> :run[m[6D[1B[2A[2K[1B[2K[1A[0m[?12l[?25hmangahk@linux-07:~/Desktop/csci241/lab-1-Keegan-Mangahas$ gradle run --args="241""[A[C[C[C[C[C[C[C[C[C[C[C[C[C[C[C[C[C[C[C[C[C[C[C[C[C[C[C[C[C[C[C[C[C[C[C[C[C[C[C[C[C[C[C[C[C[C[C[C[C[C[C[C[C[C[C[C[C[C[C[C[C[C[C[C[10Pbuild
[K[A[C[C[C[C[C[C[C[C[C[C[C[C[C[C[C[C[C[C[C[C[C[C[C[C[C[C[C[C[C[C[C[C[C[C[C[C[C[C[C[C[C[C[C[C[C[C[C[C[C[C[C[C[C[C[C[C[C[C[C[C[C[C[C[C[C[C[C[C[C[Crun --args="241""^C
mangahk@linux-07:~/Desktop/csci241/lab-1-Keegan-Mangahas$ gradle run --args="241""[A[C[C[C[C[C[C[C[C[C[C[C[C[C[C[C[C[C[C[C[C[C[C[C[C[C[C[C[C[C[C[C[C[C[C[C[C[C[C[C[C[C[C[C[C[C[C[C[C[C[C[C[C[C[C[C[C[C[C[C[C[C[C[C[C[10Pbuild
[K[A[C[C[C[C[C[C[C[C[C[C[C[C[C[C[C[C[C[C[C[C[C[C[C[C[C[C[C[C[C[C[C[C[C[C[C[C[C[C[C[C[C[C[C[C[C[C[C[C[C[C[C[C[C[C[C[C[C[C[C[C[C[C[C[C[C[C[C[C[C[Crun --args="241""[A[C[C[C[C[C[C[C[C[C[C[C[C[C[C[C[C[C[C[C[C[C[C[C[C[C[C[C[C[C[C[C[C[C[C[C[C[C[C[C[C[C[C[C[C[C[C[C[C[C[C[C[C[C[C[C[C[C[C[C[C[C[C[C[C[10Pbuild
[K[A[C[C[C[C[C[C[C[C[C[C[C[C[C[C[C[C[C[C[C[C[C[C[C[C[C[C[C[C[C[C[C[C[C[C[C[C[C[C[C[C[C[C[C[C[C[C[C[C[C[C[C[C[C[C[C[C[C[C[C[C[C[C[C[C[C[C[C[C[C[Cnano src/main/java/lab11/Hello.java 
[?1049h[22;0;0t[1;24r(B[m[4l[?7h[39;49m[?1h=[?1h=[?1h=[?25l[39;49m(B[m[H[2J[22;33H(B[0;7m[ Reading File ](B[m[22;39H(B[0;7m 7 lines ](B[m[H(B[0;7m  GNU nano 2.9.3            src/main/java/lab1/Hello.java                       [1;79H(B[m[23d(B[0;7m^G(B[m Get Help  (B[0;7m^O(B[m Write Out (B[0;7m^W(B[m Where Is  (B[0;7m^K(B[m Cut Text  (B[0;7m^J(B[m Justify   (B[0;7m^C(B[m Cur Pos[24d(B[0;7m^X(B[m Exit[14G(B[0;7m^R(B[m Read File (B[0;7m^\(B[m Replace   (B[0;7m^U(B[m Uncut Text(B[0;7m^T(B[m To Spell  (B[0;7m^_(B[m Go To Line[22d[3d[39;49m[36mpackage[39m(B[m lab1;[5d[36mpublic[39m(B[m [36mclass[39m(B[m Hello {[6;3H[36mpublic[39m(B[m [36mstatic[39m(B[m [32mvoid[39m(B[m main(String[] args) {[7;5HSystem.out.println([31m"Hello, "[39m(B[m + args);[8;3H}[9d}[3d[?12l[?25h[?25l[4d[?12l[?25h[?25l[5d[?12l[?25h[?25l[C[?12l[?25h[?25l[C[?12l[?25h[?25l[C[?12l[?25h[?25l[C[?12l[?25h[?25l[C[?12l[?25h[?25l[C[?12l[?25h[?25l [?12l[?25h[?25l[C[?12l[?25h[?25l[C[?12l[?25h[?25l[C[?12l[?25h[?25l[C[?12l[?25h[?25l[C[?12l[?25h[?25l [?12l[?25h[?25lH[?12l[?25h[?25le[?12l[?25h[?25ll[?12l[?25h[?25ll[?12l[?25h[?25lo[?12l[?25h[?25l [?12l[?25h[?25l{[?12l[?25h[?25l[6d[?12l[?25h[?25l [?12l[?25h[?25l [?12l[?25h[?25l[22d[K[6;4H[?12l[?25h[?25l[C[?12l[?25h[?25l[C[?12l[?25h[?25l[C[?12l[?25h[?25l[C[?12l[?25h[?25l[7d[?12l[?25h[?25lt[?12l[?25h[?25le[?12l[?25h[?25lm[?12l[?25h[?25l.[?12l[?25h[?25lo[?12l[?25h[?25lu[?12l[?25h[?25lt[?12l[?25h[?25l.[?12l[?25h[?25lp[?12l[?25h[?25lr[?12l[?25h[?25li[?12l[?25h[?25ln[?12l[?25h[?25lt[?12l[?25h[?25ll[?12l[?25h[?25ln[?12l[?25h[?25l([?12l[?25h[?25l[C[?12l[?25h[?25l[C[?12l[?25h[?25l[C[?12l[?25h[?25l[C[?12l[?25h[?25l[C[?12l[?25h[?25l[C[?12l[?25h[?25l[C[?12l[?25h[?25l[C[?12l[?25h[?25l[C[?12l[?25h[?25l [?12l[?25h[?25l+[?12l[?25h[?25l [?12l[?25h[?25la[?12l[?25h[?25lr[?12l[?25h[?25lg[?12l[?25h[?25ls[?12l[?25h[?25l[1;71H(B[0;7mModified(B[m[7;40H.);[?12l[?25h[?25lt);[?12l[?25h[?25lo);[?12l[?25h[?25lS);[?12l[?25h[?25lt);[?12l[?25h[?25lr);[?12l[?25h[?25li);[?12l[?25h[?25ln);[?12l[?25h[?25lg);[?12l[?25h[?25l[22d(B[0;7mSave modified buffer?  (Answering "No" will DISCARD changes.)                   [23;1H Y(B[m Yes[K[24d(B[0;7m N(B[m No  [14G   (B[0;7m^C(B[m Cancel[K[22;63H[?12l[?25h[?25l[23d(B[0;7m^G(B[m Get Help[23;21H(B[0;7mM-D(B[m DOS Format[41G(B[0;7mM-A(B[m Append[23;61H(B[0;7mM-B(B[m Backup File[24d(B[0;7m^C(B[m Cancel[17G    (B[0;7mM-M(B[m Mac Format[41G(B[0;7mM-P(B[m Prepend[24;61H(B[0;7m^T(B[m To Files[22d(B[0;7mFile Name to Write: src/main/java/lab1/Hello.java            (B[m[22;50H[?12l[?25h[?25l[K[1;79H[1;71H(B[0;7m        (B[m[22;32H(B[0;7m[ Wrote 7 lines ](B[m[J[24;80H[?12l[?25h[24;1H[?1049l[23;0;0t[?1l>mangahk@linux-07:~/Desktop/csci241/lab-1-Keegan-Mangahas$ nano src/main/java/lab11/Hello.java [A[C[C[C[C[C[C[C[C[C[C[C[C[C[C[C[C[C[C[C[C[C[C[C[C[C[C[C[C[C[C[C[C[C[C[C[C[C[C[C[C[C[C[C[C[Cgradle run --args="241"[K[A[C[C[C[C[C[C[C[C[C[C[C[C[C[C[C[C[C[C[C[C[C[C[C[C[C[C[C[C[C[C[C[C[C[C[C[C[C[C[C[C[C[C[C[C[C[C[C[C[C[C[C[C[C[C[C[C[C[C[C[C[C[C[C[C[10Pbuild
[K[A[C[C[C[C[C[C[C[C[C[C[C[C[C[C[C[C[C[C[C[C[C[C[C[C[C[C[C[C[C[C[C[C[C[C[C[C[C[C[C[C[C[C[C[C[C[C[C[C[C[C[C[C[C[C[C[C[C[C[C[C[C[C[C[C[C[C[C[C[C[C


[2A[1m<[0;1m-------------> 0% INITIALIZING [15ms][m[38D[1B[1m> Evaluating settings[m[21D[1B[2A[1m<[0;1m-------------> 0% EXECUTING [115ms][m[0K[36D[1B[1m> :compileJava[m[0K[14D[1B[2A[0K
[31;1m> Task :compileJava[0;39m[31m FAILED[39m
/home/mangahk/Desktop/csci241/lab-1-Keegan-Mangahas/src/main/java/lab1/Hello.java:5: error: cannot find symbol
    System.out.println("Hello, " + args.toString);
                                       ^
  symbol:   variable toString
  location: variable args of type String[]
1 error

[31mFAILURE: [39m[31mBuild failed with an exception.[39m

* What went wrong:
Execution failed for task ':compileJava'.
[33m> [39mCompilation failed; see the compiler error output for details.

* Try:
Run with [1m--stacktrace[m option to get the stack trace. Run with [1m--info[m or [1m--debug[m option to get more log output. Run with [1m--scan[m to get full insights.

* Get more help at [1mhttps://help.gradle.org[m

[31;1mBUILD FAILED[0;39m in 678ms
1 actionable task: 1 executed
[0K
[0K
[2A[1m<[0;1m-------------> 0% WAITING[m[26D[1B> IDLE[6D[1B[2A[2K[1B[2K[1A[0m[?12l[?25hmangahk@linux-07:~/Desktop/csci241/lab-1-Keegan-Mangahas$ gradle buildnano src/main/java/lab11/Hello.java 
[?1049h[22;0;0t[1;24r(B[m[4l[?7h[39;49m[?1h=[?1h=[?1h=[?25l[39;49m(B[m[H[2J[22;33H(B[0;7m[ Reading File ](B[m[22;39H(B[0;7m 7 lines ](B[m[H(B[0;7m  GNU nano 2.9.3            src/main/java/lab1/Hello.java                       [1;79H(B[m[23d(B[0;7m^G(B[m Get Help  (B[0;7m^O(B[m Write Out (B[0;7m^W(B[m Where Is  (B[0;7m^K(B[m Cut Text  (B[0;7m^J(B[m Justify   (B[0;7m^C(B[m Cur Pos[24d(B[0;7m^X(B[m Exit[14G(B[0;7m^R(B[m Read File (B[0;7m^\(B[m Replace   (B[0;7m^U(B[m Uncut Text(B[0;7m^T(B[m To Spell  (B[0;7m^_(B[m Go To Line[22d[3d[39;49m[36mpackage[39m(B[m lab1;[5d[36mpublic[39m(B[m [36mclass[39m(B[m Hello {[6;3H[36mpublic[39m(B[m [36mstatic[39m(B[m [32mvoid[39m(B[m main(String[] args) {[7;5HSystem.out.println([31m"Hello, "[39m(B[m + args.toString);[8;3H}[9d}[3d[?12l[?25h[?25l[4d[?12l[?25h[?25l[5d[?12l[?25h[?25l[C[?12l[?25h[?25l[C[?12l[?25h[?25l[C[?12l[?25h[?25l[C[?12l[?25h[?25l[C[?12l[?25h[?25l[C[?12l[?25h[?25l [?12l[?25h[?25l[C[?12l[?25h[?25l[C[?12l[?25h[?25l[C[?12l[?25h[?25l[C[?12l[?25h[?25l[C[?12l[?25h[?25l [?12l[?25h[?25lH[?12l[?25h[?25l[6d[?12l[?25h[?25l[C[?12l[?25h[?25l [?12l[?25h[?25l[C[?12l[?25h[?25l[C[?12l[?25h[?25l[C[?12l[?25h[?25l[C[?12l[?25h[?25l [?12l[?25h[?25lm[?12l[?25h[?25l[22d[K[6;24H[?12l[?25h[?25li[?12l[?25h[?25ln[?12l[?25h[?25l([?12l[?25h[?25lS[?12l[?25h[?25lt[?12l[?25h[?25lr[?12l[?25h[?25li[?12l[?25h[?25ln[?12l[?25h[?25lg[?12l[?25h[?25l[[?12l[?25h[?25l][?12l[?25h[?25l [?12l[?25h[?25la[?12l[?25h[?25lr[?12l[?25h[?25lg[?12l[?25h[?25ls[?12l[?25h[?25l)[?12l[?25h[?25l [?12l[?25h[?25l[7d[?12l[?25h[?25l[8;4H[?12l[?25h[?25l[?12l[?25h[?25l[?12l[?25h[?25l[?12l[?25h[?25l[7;51H[?12l[?25h[?25l[?12l[?25h[?25l[?12l[?25h[?25l[?12l[?25h[?25l[?12l[?25h[?25l[?12l[?25h[?25l[?12l[?25h[?25l[?12l[?25h[?25l[?12l[?25h[?25l[?12l[?25h[?25l[?12l[?25h[?25l.[?12l[?25h[?25lt[?12l[?25h[?25lo[?12l[?25h[?25lS[?12l[?25h[?25lt[?12l[?25h[?25lr[?12l[?25h[?25li[?12l[?25h[?25ln[?12l[?25h[?25lg[?12l[?25h[?25l[1;71H(B[0;7mModified(B[m[7;48H);[K[?12l[?25h[?25l);[K[?12l[?25h[?25l);[K[?12l[?25h[?25l);[K[?12l[?25h[?25l);[K[?12l[?25h[?25l);[K[?12l[?25h[?25l);[K[?12l[?25h[?25l);[K[?12l[?25h[?25l);[K[?12l[?25h[?25l);[K[?12l[?25h[?25l);[K[?12l[?25h[?25l);[K[?12l[?25h[?25l);[K[?12l[?25h[?25lA);[?12l[?25h[?25lr);[?12l[?25h[?25lrr);[?12l[?25h[?25la);[?12l[?25h[?25ly);[?12l[?25h[?25ls);[?12l[?25h[?25l.);[?12l[?25h[?25lt);[?12l[?25h[?25lo);[?12l[?25h[?25lS);[?12l[?25h[?25lt);[?12l[?25h[?25lr);[?12l[?25h[?25li);[?12l[?25h[?25ln);[?12l[?25h[?25lg);[?12l[?25h[?25l();[?12l[?25h[?25la);[?12l[?25h[?25lr);[?12l[?25h[?25lg);[?12l[?25h[?25lt);[?12l[?25h[?25ls);[?12l[?25h[?25l);[K[?12l[?25h[?25l);[K[?12l[?25h[?25ls);[?12l[?25h[?25l));[?12l[?25h[?25l;[K[?12l[?25h[?25l));[?12l[?25h[?25l[22d(B[0;7mSave modified buffer?  (Answering "No" will DISCARD changes.)                   [23;1H Y(B[m Yes[K[24d(B[0;7m N(B[m No  [14G   (B[0;7m^C(B[m Cancel[K[22;63H[?12l[?25h[?25l[23d(B[0;7m^G(B[m Get Help[23;21H(B[0;7mM-D(B[m DOS Format[41G(B[0;7mM-A(B[m Append[23;61H(B[0;7mM-B(B[m Backup File[24d(B[0;7m^C(B[m Cancel[17G    (B[0;7mM-M(B[m Mac Format[41G(B[0;7mM-P(B[m Prepend[24;61H(B[0;7m^T(B[m To Files[22d(B[0;7mFile Name to Write: src/main/java/lab1/Hello.java            (B[m[22;50H[?12l[?25h[?25l[K[1;79H[1;71H(B[0;7m        (B[m[22;32H(B[0;7m[ Wrote 7 lines ](B[m[J[24;80H[?12l[?25h[24;1H[?1049l[23;0;0t[?1l>mangahk@linux-07:~/Desktop/csci241/lab-1-Keegan-Mangahas$ nano src/main/java/lab11/Hello.java [A[C[C[C[C[C[C[C[C[C[C[C[C[C[C[C[C[C[C[C[C[C[C[C[C[C[C[C[C[C[C[C[C[C[C[C[C[C[C[C[C[C[C[C[C[C[10Pgradle build
[K[A[C[C[C[C[C[C[C[C[C[C[C[C[C[C[C[C[C[C[C[C[C[C[C[C[C[C[C[C[C[C[C[C[C[C[C[C[C[C[C[C[C[C[C[C[C[C[C[C[C[C[C[C[C[C[C[C[C[C[C[C[C[C[C[C[C[C[C[C[C[C


[2A[1m<[0;1m-------------> 0% EXECUTING [103ms][m[36D[1B[1m> :compileJava[m[14D[1B[2A[0K
[31;1m> Task :compileJava[0;39m[31m FAILED[39m
/home/mangahk/Desktop/csci241/lab-1-Keegan-Mangahas/src/main/java/lab1/Hello.java:5: error: cannot find symbol
    System.out.println("Hello, " + Arrays.toString(args));
                                   ^
  symbol:   variable Arrays
  location: class Hello
1 error

[31mFAILURE: [39m[31mBuild failed with an exception.[39m

* What went wrong:
Execution failed for task ':compileJava'.
[33m> [39mCompilation failed; see the compiler error output for details.

* Try:
Run with [1m--stacktrace[m option to get the stack trace. Run with [1m--info[m or [1m--debug[m option to get more log output. Run with [1m--scan[m to get full insights.

* Get more help at [1mhttps://help.gradle.org[m

[31;1mBUILD FAILED[0;39m in 664ms
1 actionable task: 1 executed
[0K
[0K
[2A[1m<[0;1m-------------> 0% WAITING[m[26D[1B> IDLE[6D[1B[2A[2K[1B[2K[1A[0m[?12l[?25hmangahk@linux-07:~/Desktop/csci241/lab-1-Keegan-Mangahas$ gradle buildnano src/main/java/lab11/Hello.java [A[C[C[C[C[C[C[C[C[C[C[C[C[C[C[C[C[C[C[C[C[C[C[C[C[C[C[C[C[C[C[C[C[C[C[C[C[C[C[C[C[C[C[C[C[C[10Pgradle build
[K[A[C[C[C[C[C[C[C[C[C[C[C[C[C[C[C[C[C[C[C[C[C[C[C[C[C[C[C[C[C[C[C[C[C[C[C[C[C[C[C[C[C[C[C[C[C[C[C[C[C[C[C[C[C[C[C[C[C[C[C[C[C[C[C[C[C[C[C[C[C[Cnano src/main/java/lab11/Hello.java 
[?1049h[22;0;0t[1;24r(B[m[4l[?7h[39;49m[?1h=[?1h=[?1h=[?25l[39;49m(B[m[H[2J[22;33H(B[0;7m[ Reading File ](B[m[22;39H(B[0;7m 7 lines ](B[m[H(B[0;7m  GNU nano 2.9.3            src/main/java/lab1/Hello.java                       [1;79H(B[m[23d(B[0;7m^G(B[m Get Help  (B[0;7m^O(B[m Write Out (B[0;7m^W(B[m Where Is  (B[0;7m^K(B[m Cut Text  (B[0;7m^J(B[m Justify   (B[0;7m^C(B[m Cur Pos[24d(B[0;7m^X(B[m Exit[14G(B[0;7m^R(B[m Read File (B[0;7m^\(B[m Replace   (B[0;7m^U(B[m Uncut Text(B[0;7m^T(B[m To Spell  (B[0;7m^_(B[m Go To Line[22d[3d[39;49m[36mpackage[39m(B[m lab1;[5d[36mpublic[39m(B[m [36mclass[39m(B[m Hello {[6;3H[36mpublic[39m(B[m [36mstatic[39m(B[m [32mvoid[39m(B[m main(String[] args) {[7;5HSystem.out.println([31m"Hello, "[39m(B[m + Arrays.toString(args));[8;3H}[9d}[3d[?12l[?25h[?25l[4d[?12l[?25h[?25l[5d[?12l[?25h[?25l[6d[?12l[?25h[?25l[7d[?12l[?25h[?25l [?12l[?25h[?25l [?12l[?25h[?25l [?12l[?25h[?25l [?12l[?25h[?25lS[?12l[?25h[?25ly[?12l[?25h[?25ls[?12l[?25h[?25lt[?12l[?25h[?25le[?12l[?25h[?25lm[?12l[?25h[?25l.[?12l[?25h[?25lo[?12l[?25h[?25lu[?12l[?25h[?25lt[?12l[?25h[?25l.[?12l[?25h[?25lp[?12l[?25h[?25lr[?12l[?25h[?25li[?12l[?25h[?25ln[?12l[?25h[?25lt[?12l[?25h[?25ll[?12l[?25h[?25l[22d[K[7;23H[?12l[?25h[?25l([?12l[?25h[?25l[C[?12l[?25h[?25l[C[?12l[?25h[?25l[C[?12l[?25h[?25l[29G[?12l[?25h[?25l[C[?12l[?25h[?25l[C[?12l[?25h[?25l[C[?12l[?25h[?25l[C[?12l[?25h[?25l [?12l[?25h[?25l+[?12l[?25h[?25l [?12l[?25h[?25lA[?12l[?25h[?25lr[?12l[?25h[?25lr[?12l[?25h[?25la[?12l[?25h[?25ly[?12l[?25h[?25ls[?12l[?25h[?25l.[?12l[?25h[?25lt[?12l[?25h[?25lo[?12l[?25h[?25lS[?12l[?25h[?25lt[?12l[?25h[?25lr[?12l[?25h[?25li[?12l[?25h[?25ln[?12l[?25h[?25lg[?12l[?25h[?25l([?12l[?25h[?25la[?12l[?25h[?25lr[?12l[?25h[?25lg[?12l[?25h[?25ls[?12l[?25h[?25l)[?12l[?25h[?25l)[?12l[?25h[?25l[?12l[?25h[?25l[1;71H(B[0;7mModified(B[m[7;57H;[K[?12l[?25h[?25l);[K[?12l[?25h[?25l);[K[?12l[?25h[?25l);[K[?12l[?25h[?25l);[K[?12l[?25h[?25l);[K[?12l[?25h[?25l);[K[?12l[?25h[?25l);[K[?12l[?25h[?25l);[K[?12l[?25h[?25l);[K[?12l[?25h[?25l);[K[?12l[?25h[?25l);[K[?12l[?25h[?25l);[K[?12l[?25h[?25l);[K[?12l[?25h[?25l);[K[?12l[?25h[?25l);[K[?12l[?25h[?25l);[K[?12l[?25h[?25l);[K[?12l[?25h[?25lr);[K[?12l[?25h[?25l);[K[?12l[?25h[?25l);[K[?12l[?25h[?25la);[?12l[?25h[?25lr);[?12l[?25h[?25lg);[?12l[?25h[?25ls);[?12l[?25h[?25l[);[?12l[?25h[?25l0);[?12l[?25h[?25l]);[?12l[?25h[?25l)[?12l[?25h[?25l[22d(B[0;7mSave modified buffer?  (Answering "No" will DISCARD changes.)                   [23;1H Y(B[m Yes[K[24d(B[0;7m N(B[m No  [14G   (B[0;7m^C(B[m Cancel[K[22;63H[?12l[?25h[?25l[23d(B[0;7m^G(B[m Get Help[23;21H(B[0;7mM-D(B[m DOS Format[41G(B[0;7mM-A(B[m Append[23;61H(B[0;7mM-B(B[m Backup File[24d(B[0;7m^C(B[m Cancel[17G    (B[0;7mM-M(B[m Mac Format[41G(B[0;7mM-P(B[m Prepend[24;61H(B[0;7m^T(B[m To Files[22d(B[0;7mFile Name to Write: src/main/java/lab1/Hello.java            (B[m[22;50H[?12l[?25h[?25l[K[1;79H[1;71H(B[0;7m        (B[m[22;32H(B[0;7m[ Wrote 7 lines ](B[m[J[24;80H[?12l[?25h[24;1H[?1049l[23;0;0t[?1l>mangahk@linux-07:~/Desktop/csci241/lab-1-Keegan-Mangahas$ nano src/main/java/lab11/Hello.java [A[C[C[C[C[C[C[C[C[C[C[C[C[C[C[C[C[C[C[C[C[C[C[C[C[C[C[C[C[C[C[C[C[C[C[C[C[C[C[C[C[C[C[C[C[C[10Pgradle build
[K[A[C[C[C[C[C[C[C[C[C[C[C[C[C[C[C[C[C[C[C[C[C[C[C[C[C[C[C[C[C[C[C[C[C[C[C[C[C[C[C[C[C[C[C[C[C[C[C[C[C[C[C[C[C[C[C[C[C[C[C[C[C[C[C[C[C[C[C[C[C[C


[2A[1m<[0;1m-------------> 0% EXECUTING [107ms][m[36D[1B[1m> :compileJava[m[14D[1B[2A[1m<[0;32;1m====[0;39;1m---------> 35% EXECUTING [207ms][m[37D[1B[1m> :distTar[m[0K[10D[1B[2A[1m<[0;32;1m=====[0;39;1m--------> 42% EXECUTING [307ms][m[37D[1B[1m> :distZip[m[10D[1B[2A[0K
[32;1mBUILD SUCCESSFUL[0;39m in 937ms
5 actionable tasks: 4 executed, 1 up-to-date
[0K
[0K
[2A[1m<[0;1m-------------> 0% WAITING[m[26D[1B> IDLE[6D[1B[2A[2K[1B[2K[1A[0m[?12l[?25hmangahk@linux-07:~/Desktop/csci241/lab-1-Keegan-Mangahas$ gradle buildnano src/main/java/lab11/Hello.java [A[C[C[C[C[C[C[C[C[C[C[C[C[C[C[C[C[C[C[C[C[C[C[C[C[C[C[C[C[C[C[C[C[C[C[C[C[C[C[C[C[C[C[C[C[C[10Pgradle build
[K[A[C[C[C[C[C[C[C[C[C[C[C[C[C[C[C[C[C[C[C[C[C[C[C[C[C[C[C[C[C[C[C[C[C[C[C[C[C[C[C[C[C[C[C[C[C[C[C[C[C[C[C[C[C[C[C[C[C[C[C[C[C[C[C[C[C[C[C[C[C[Cnano src/main/java/lab11/Hello.java [A[C[C[C[C[C[C[C[C[C[C[C[C[C[C[C[C[C[C[C[C[C[C[C[C[C[C[C[C[C[C[C[C[C[C[C[C[C[C[C[C[C[C[C[C[C[10Pgradle build
[K[A[C[C[C[C[C[C[C[C[C[C[C[C[C[C[C[C[C[C[C[C[C[C[C[C[C[C[C[C[C[C[C[C[C[C[C[C[C[C[C[C[C[C[C[C[C[C[C[C[C[C[C[C[C[C[C[C[C[C[C[C[C[C[C[C[C[C[C[C[C[Cnano src/main/java/lab11/Hello.java [A[C[C[C[C[C[C[C[C[C[C[C[C[C[C[C[C[C[C[C[C[C[C[C[C[C[C[C[C[C[C[C[C[C[C[C[C[C[C[C[C[C[C[C[C[Cgradle run --args="241"[K


[2A[1m<[0;1m-------------> 0% INITIALIZING [12ms][m[38D[1B[1m> Evaluating settings[m[21D[1B[2A[1m<[0;32;1m=========[0;39;1m----> 75% EXECUTING [112ms][m[0K[37D[1B[1m> :run[m[0K[6D[1B[2A[0K
[1m> Task :run[m
Hello, 241

[32;1mBUILD SUCCESSFUL[0;39m in 652ms
2 actionable tasks: 1 executed, 1 up-to-date
[0K
[0K
[2A[1m<[0;1m-------------> 0% WAITING[m[26D[1B[1m> :run[m[6D[1B[2A[2K[1B[2K[1A[0m[?12l[?25hmangahk@linux-07:~/Desktop/csci241/lab-1-Keegan-Mangahas$ gradle run --args="241""[A[C[C[C[C[C[C[C[C[C[C[C[C[C[C[C[C[C[C[C[C[C[C[C[C[C[C[C[C[C[C[C[C[C[C[C[C[C[C[C[C[C[C[C[C[C[C[C[C[C[C[C[C[C[C[C[C[C[C[C[C[C[C[C[C[10Pbuild
[K[A[C[C[C[C[C[C[C[C[C[C[C[C[C[C[C[C[C[C[C[C[C[C[C[C[C[C[C[C[C[C[C[C[C[C[C[C[C[C[C[C[C[C[C[C[C[C[C[C[C[C[C[C[C[C[C[C[C[C[C[C[C[C[C[C[C[C[C[C[C[Cnano src/main/java/lab11/Hello.java 
[?1049h[22;0;0t[1;24r(B[m[4l[?7h[39;49m[?1h=[?1h=[?1h=[?25l[39;49m(B[m[H[2J[22;33H(B[0;7m[ Reading File ](B[m[22;39H(B[0;7m 7 lines ](B[m[H(B[0;7m  GNU nano 2.9.3            src/main/java/lab1/Hello.java                       [1;79H(B[m[23d(B[0;7m^G(B[m Get Help  (B[0;7m^O(B[m Write Out (B[0;7m^W(B[m Where Is  (B[0;7m^K(B[m Cut Text  (B[0;7m^J(B[m Justify   (B[0;7m^C(B[m Cur Pos[24d(B[0;7m^X(B[m Exit[14G(B[0;7m^R(B[m Read File (B[0;7m^\(B[m Replace   (B[0;7m^U(B[m Uncut Text(B[0;7m^T(B[m To Spell  (B[0;7m^_(B[m Go To Line[22d[3d[39;49m[36mpackage[39m(B[m lab1;[5d[36mpublic[39m(B[m [36mclass[39m(B[m Hello {[6;3H[36mpublic[39m(B[m [36mstatic[39m(B[m [32mvoid[39m(B[m main(String[] args) {[7;5HSystem.out.println([31m"Hello, "[39m(B[m + args[0]);[8;3H}[9d}[3d[?12l[?25h[?25l[4d[?12l[?25h[?25l[5d[?12l[?25h[?25l[6d[?12l[?25h[?25l [?12l[?25h[?25l [?12l[?25h[?25l[C[?12l[?25h[?25l[C[?12l[?25h[?25l[C[?12l[?25h[?25l[C[?12l[?25h[?25l[C[?12l[?25h[?25l[C[?12l[?25h[?25l [?12l[?25h[?25l[C[?12l[?25h[?25l[C[?12l[?25h[?25l[C[?12l[?25h[?25l[C[?12l[?25h[?25l[C[?12l[?25h[?25l[C[?12l[?25h[?25l [?12l[?25h[?25l[C[?12l[?25h[?25l[C[?12l[?25h[?25l[C[?12l[?25h[?25l[C[?12l[?25h[?25l [?12l[?25h[?25lm[?12l[?25h[?25l[22d[K[6;24H[?12l[?25h[?25li[?12l[?25h[?25ln[?12l[?25h[?25l([?12l[?25h[?25lS[?12l[?25h[?25lt[?12l[?25h[?25lr[?12l[?25h[?25li[?12l[?25h[?25ln[?12l[?25h[?25lg[?12l[?25h[?25l[[?12l[?25h[?25l][?12l[?25h[?25l [?12l[?25h[?25la[?12l[?25h[?25lr[?12l[?25h[?25lg[?12l[?25h[?25ls[?12l[?25h[?25l[7d[?12l[?25h[?25l[[?12l[?25h[?25l0[?12l[?25h[?25l][?12l[?25h[?25l[1;71H(B[0;7mModified(B[m[7;43H );[?12l[?25h[?25l+);[?12l[?25h[?25l );[?12l[?25h[?25l");[?12l[?25h[?25l1);[?12l[?25h[?25l[31m"1"[39m(B[m);[?12l[?25h[?25l"1);[K[?12l[?25h[?25l);[K[?12l[?25h[?25l!);[?12l[?25h[?25l[31m"!"[39m(B[m);[?12l[?25h[?25l[22d(B[0;7mSave modified buffer?  (Answering "No" will DISCARD changes.)                   [23;1H Y(B[m Yes[K[24d(B[0;7m N(B[m No  [14G   (B[0;7m^C(B[m Cancel[K[22;63H[?12l[?25h[?25l[23d(B[0;7m^G(B[m Get Help[23;21H(B[0;7mM-D(B[m DOS Format[41G(B[0;7mM-A(B[m Append[23;61H(B[0;7mM-B(B[m Backup File[24d(B[0;7m^C(B[m Cancel[17G    (B[0;7mM-M(B[m Mac Format[41G(B[0;7mM-P(B[m Prepend[24;61H(B[0;7m^T(B[m To Files[22d(B[0;7mFile Name to Write: src/main/java/lab1/Hello.java            (B[m[22;50H[?12l[?25h[?25l[K[1;79H[1;71H(B[0;7m        (B[m[22;32H(B[0;7m[ Wrote 7 lines ](B[m[J[24;80H[?12l[?25h[24;1H[?1049l[23;0;0t[?1l>mangahk@linux-07:~/Desktop/csci241/lab-1-Keegan-Mangahas$ nano src/main/java/lab11/Hello.java [A[C[C[C[C[C[C[C[C[C[C[C[C[C[C[C[C[C[C[C[C[C[C[C[C[C[C[C[C[C[C[C[C[C[C[C[C[C[C[C[C[C[C[C[C[Cgradle run --args="241"[K[A[C[C[C[C[C[C[C[C[C[C[C[C[C[C[C[C[C[C[C[C[C[C[C[C[C[C[C[C[C[C[C[C[C[C[C[C[C[C[C[C[C[C[C[C[C[C[C[C[C[C[C[C[C[C[C[C[C[C[C[C[C[C[C[C[10Pbuild
[K[A[C[C[C[C[C[C[C[C[C[C[C[C[C[C[C[C[C[C[C[C[C[C[C[C[C[C[C[C[C[C[C[C[C[C[C[C[C[C[C[C[C[C[C[C[C[C[C[C[C[C[C[C[C[C[C[C[C[C[C[C[C[C[C[C[C[C[C[C[C[C


[2A[1m<[0;1m-------------> 0% CONFIGURING [14ms][m[37D[1B[1m> root project[m[14D[1B[2A[1m<[0;1m-------------> 0% EXECUTING [114ms][m[0K[36D[1B[1m> :compileJava[m[14D[1B[2A[1m<[0;32;1m=====[0;39;1m--------> 42% EXECUTING [214ms][m[37D[1B[1m> :distZip[m[0K[10D[1B[2A[1m<[0;32;1m=====[0;39;1m--------> 42% EXECUTING [314ms][m[37D[2B[2A[0K
[32;1mBUILD SUCCESSFUL[0;39m in 871ms
5 actionable tasks: 4 executed, 1 up-to-date
[0K
[0K
[2A[1m<[0;1m-------------> 0% WAITING[m[26D[1B> IDLE[6D[1B[2A[2K[1B[2K[1A[0m[?12l[?25hmangahk@linux-07:~/Desktop/csci241/lab-1-Keegan-Mangahas$ gradle buildnano src/main/java/lab11/Hello.java [A[C[C[C[C[C[C[C[C[C[C[C[C[C[C[C[C[C[C[C[C[C[C[C[C[C[C[C[C[C[C[C[C[C[C[C[C[C[C[C[C[C[C[C[C[Cgradle run --args="241"[K


[2A[1m<[0;32;1m=========[0;39;1m----> 75% EXECUTING [90ms][m[36D[1B[1m> :run[m[6D[1B[2A[0K
[1m> Task :run[m
Hello, 241!

[32;1mBUILD SUCCESSFUL[0;39m in 677ms
2 actionable tasks: 1 executed, 1 up-to-date
[0K
[0K
[2A[1m<[0;1m-------------> 0% WAITING[m[26D[1B[1m> :run[m[6D[1B[2A[2K[1B[2K[1A[0m[?12l[?25hmangahk@linux-07:~/Desktop/csci241/lab-1-Keegan-Mangahas$ git add src/main/java/ lab1/Hello.java 
mangahk@linux-07:~/Desktop/csci241/lab-1-Keegan-Mangahas$ git commit -m "Hello n iw prings command[K[K[K[K[K[K[K[K[K[K[K[K[K[K[K[K[K[A[C[C[C[C[C[C[C[C[C[C[C[C[C[C[C[C[C[C[C[C[C[C[C[C[C[C[C[C[C[C[C[C[C[C[C[C[C[C[C[C[C[C[C[C[C[C[C[C[C[C[C[C[C[C[C[C[C[C[C[C[C[C[C[C[C[C[C[C[C[C[C[C[C[C[C[C[C[C[C[K
[K[A[C[C[C[C[C[C[C[C[C[C[C[C[C[C[C[C[C[C[C[C[C[C[C[C[C[C[C[C[C[C[C[C[C[C[C[C[C[C[C[C[C[C[C[C[C[C[C[C[C[C[C[C[C[C[C[C[C[C[C[C[C[C[C[C[C[C[C[C[C[C[C[C[C[C[C[C[C[C[Cn ow prings command line arg"
[master 33b6ce5] Hello now prings command line arg
 1 file changed, 1 insertion(+), 1 deletion(-)
mangahk@linux-07:~/Desktop/csci241/lab-1-Keegan-Mangahas$ git push
Username for 'https://github.com': Keeganm-Mangahas          -Mangahas
Password for 'https://Keegan-Mangahas@github.com': 
Counting objects: 7, done.
Delta compression using up to 8 threads.
Compressing objects:  33% (1/3)   Compressing objects:  66% (2/3)   Compressing objects: 100% (3/3)   Compressing objects: 100% (3/3), done.
Writing objects:  14% (1/7)   Writing objects:  28% (2/7)   Writing objects:  42% (3/7)   Writing objects:  57% (4/7)   Writing objects:  71% (5/7)   Writing objects:  85% (6/7)   Writing objects: 100% (7/7)   Writing objects: 100% (7/7), 488 bytes | 244.00 KiB/s, done.
Total 7 (delta 2), reused 0 (delta 0)
remote: Resolving deltas:   0% (0/2)[Kremote: Resolving deltas:  50% (1/2)[Kremote: Resolving deltas: 100% (2/2)[Kremote: Resolving deltas: 100% (2/2), completed with 2 local objects.[K
To https://github.com/csci241-20s/lab-1-Keegan-Mangahas
   3b814b0..33b6ce5  master -> master
mangahk@linux-07:~/Desktop/csci241/lab-1-Keegan-Mangahas$ exit
exit

Script done on 2020-04-08 19:54:02-0700
